CATAGCTGTGCCTGACAACTGACT -> ATAGCTGTGCCTGACAACTGACTT
GACTAGACGCCGGAGGCACGCTGG -> ACTAGACGCCGGAGGCACGCTGGA
CATACACGAAGTTTCGAGGCGACG -> ATACACGAAGTTTCGAGGCGACGT
CATAAAACGATCTCCGTTGTTCTC -> ATAAAACGATCTCCGTTGTTCTCG
TACTTCCGGTATTTTTCGAGAGAA -> ACTTCCGGTATTTTTCGAGAGAAG
GGACCCCATCTCCACCCATGACGA -> GACCCCATCTCCACCCATGACGAT
TCGAGGCGACGTCGTTTACGCCAT -> CGAGGCGACGTCGTTTACGCCATA
TCTATCGGGGATGACTCCGGTTTG -> CTATCGGGGATGACTCCGGTTTGT
CTGACCCCTGGACCCGCTACAGTC -> TGACCCCTGGACCCGCTACAGTCT
TTAAACCGCAGTTTATTGTATTCA -> TAAACCGCAGTTTATTGTATTCAG
TGGTACTTCCGGTATTTTTCGAGA -> GGTACTTCCGGTATTTTTCGAGAG
TAGCACTACCCGCTAACCCGCAAC -> AGCACTACCCGCTAACCCGCAACA
GAACTTTAGACAAGAAAAATGCTT -> AACTTTAGACAAGAAAAATGCTTC
ACCGTGTCAAAGGTTATTACATAA -> CCGTGTCAAAGGTTATTACATAAA
TGGGTGTGACGCTTCGCGCGACTA -> GGGTGTGACGCTTCGCGCGACTAG
CCGCTTGGACTGAACCCTTATAAC -> CGCTTGGACTGAACCCTTATAACG
GACAATGTTGATCCGCAACGCTCA -> ACAATGTTGATCCGCAACGCTCAC
TAAGACGCCGACTTTGAACATGTG -> AAGACGCCGACTTTGAACATGTGA
AACCCCATGAGAATCCGAATTGCA -> ACCCCATGAGAATCCGAATTGCAA
CGTTATCTAAATTCGCCCGCCTGT -> GTTATCTAAATTCGCCCGCCTGTC
GTGTGACGTTTCCCACGGGCTGAA -> TGTGACGTTTCCCACGGGCTGAAT
AGGCTAAGACGCCGACTTTGAACA -> GGCTAAGACGCCGACTTTGAACAT
CATGGACCAACTGCTCATGATGAA -> ATGGACCAACTGCTCATGATGAAA
TGCATAGCAGAAGGTCCTCGGAAC -> GCATAGCAGAAGGTCCTCGGAACT
TTCGTCCGGCTTACGAAATTTATC -> TCGTCCGGCTTACGAAATTTATCG
CAGTTTATTGTATTCAGTTGTCGG -> AGTTTATTGTATTCAGTTGTCGGC
TTCCCGCGAAGCTCGAATTTCCCA -> TCCCGCGAAGCTCGAATTTCCCAG
TTGTAGACGCATCGAGACAAGCAT -> TGTAGACGCATCGAGACAAGCATG
GCTAGGTCCACACGTCGAGACGAA -> CTAGGTCCACACGTCGAGACGAAT
TGAGTATTACGCGTTAAGTATCTA -> GAGTATTACGCGTTAAGTATCTAA
TGACACGTGTGCCCAATGGGCGTT -> GACACGTGTGCCCAATGGGCGTTT
TCGAAGCTTGAGACGAGTCTGAGA -> CGAAGCTTGAGACGAGTCTGAGAG
CACGCTGGACCCCATCTCCACCCA -> ACGCTGGACCCCATCTCCACCCAT
GGTTATAAGGTGCATTGAGATCAC -> GTTATAAGGTGCATTGAGATCACA
ATTGCGGCGGTCGAACGAGAGTTA -> TTGCGGCGGTCGAACGAGAGTTAG
ACGCTCACCCTTAGATCAATTCCC -> CGCTCACCCTTAGATCAATTCCCG
GCAGAAGGTCCTCGGAACTTTAGA -> CAGAAGGTCCTCGGAACTTTAGAC
AATCGACCCACTGTGGCTCTAGCA -> ATCGACCCACTGTGGCTCTAGCAC
TTCGATACGTCGGGCGGGAAATCC -> TCGATACGTCGGGCGGGAAATCCG
GAACCACAGGTCGGATTATGGTAT -> AACCACAGGTCGGATTATGGTATA
TTTTGCCTTTAGCTCAGGATGTAT -> TTTGCCTTTAGCTCAGGATGTATG
GCGAAAAGCTAAGGCTTTTCGATA -> CGAAAAGCTAAGGCTTTTCGATAC
GATAGCGGCTGCTTCCATAGGCTA -> ATAGCGGCTGCTTCCATAGGCTAA
CTACAGTCTCAAATCTGACGCTAG -> TACAGTCTCAAATCTGACGCTAGG
CTAAGACGCCGACTTTGAACATGT -> TAAGACGCCGACTTTGAACATGTG
ACGCTGTAAAATTCCGTATGGGCC -> CGCTGTAAAATTCCGTATGGGCCG
AGAGTTAGTCCCGATATGGGTCCT -> GAGTTAGTCCCGATATGGGTCCTG
GTTCAACCAAGACATGGTACTTCC -> TTCAACCAAGACATGGTACTTCCG
GTGTGTCCTTCGGCGTGTTGGCGG -> TGTGTCCTTCGGCGTGTTGGCGGG
GGCTCTAGCACCTCAGTCGAGAAC -> GCTCTAGCACCTCAGTCGAGAACG
ATGGATATGGACGAGATTGACGTG -> TGGATATGGACGAGATTGACGTGG
GACCGGCATGGGCGATACAGCCCG -> ACCGGCATGGGCGATACAGCCCGA
TTTCGAGAGAAGAATGTGTCTGTA -> TTCGAGAGAAGAATGTGTCTGTAC
GGGTATGAACCACGACCGCTTGGA -> GGTATGAACCACGACCGCTTGGAC
ATAAGTCACGCGATAGCGGCTGCT -> TAAGTCACGCGATAGCGGCTGCTT
GAGTTAGTCCCGATATGGGTCCTG -> AGTTAGTCCCGATATGGGTCCTGT
CATAGCAGAAGGTCCTCGGAACTT -> ATAGCAGAAGGTCCTCGGAACTTT
GGTGTTTTGCCTTTAGCTCAGGAT -> GTGTTTTGCCTTTAGCTCAGGATG
ACTGAACCCTTATAACGGCTCTCG -> CTGAACCCTTATAACGGCTCTCGA
CGCCATAGCTGTGCCTGACAACTG -> GCCATAGCTGTGCCTGACAACTGA
CTGTTCTCCAGAAGATCTCGTGGT -> TGTTCTCCAGAAGATCTCGTGGTT
CCGACTTTGAACATGTGAGTTCAA -> CGACTTTGAACATGTGAGTTCAAC
TTTGAAACATGCCAATAGGCACTA -> TTGAAACATGCCAATAGGCACTAT
TTCACGAGTACGTTAACGCTGTAA -> TCACGAGTACGTTAACGCTGTAAA
CAACCCCATGAGAATCCGAATTGC -> AACCCCATGAGAATCCGAATTGCA
TATTTAAATCGCCAGAACTCGATT -> ATTTAAATCGCCAGAACTCGATTT
TAAGGTGCATTGAGATCACACAAC -> AAGGTGCATTGAGATCACACAACA
TCTCCGTTGTTCTCGTCGAAGCTT -> CTCCGTTGTTCTCGTCGAAGCTTG
TATTCAGTTGTCGGCCTGCATGGG -> ATTCAGTTGTCGGCCTGCATGGGT
ATAGGCTAAGACGCCGACTTTGAA -> TAGGCTAAGACGCCGACTTTGAAC
GCGGCGGTCGAACGAGAGTTAGTC -> CGGCGGTCGAACGAGAGTTAGTCC
TCGAACGAGAGTTAGTCCCGATAT -> CGAACGAGAGTTAGTCCCGATATG
AGTTTATTGTATTCAGTTGTCGGC -> GTTTATTGTATTCAGTTGTCGGCC
CTCGTCGAAGCTTGAGACGAGTCT -> TCGTCGAAGCTTGAGACGAGTCTG
ATTGAGATCACACAACATCTCTTC -> TTGAGATCACACAACATCTCTTCT
TCTCTCTATATTTAAATCGCCAGA -> CTCTCTATATTTAAATCGCCAGAA
TACATAAAACGATCTCCGTTGTTC -> ACATAAAACGATCTCCGTTGTTCT
CATTTCGTCCGGCTTACGAAATTT -> ATTTCGTCCGGCTTACGAAATTTA
GTATGGGCCGATACTGACCCCTGG -> TATGGGCCGATACTGACCCCTGGA
GCTCGATCAACGTTTATTGAGTCA -> CTCGATCAACGTTTATTGAGTCAT
AAAATGCTTCGCCTCCGGCTTGGC -> AAATGCTTCGCCTCCGGCTTGGCG
GTGCTCGTTATCTAAATTCGCCCG -> TGCTCGTTATCTAAATTCGCCCGC
GCACTATACCTAGCCCTCTATCGG -> CACTATACCTAGCCCTCTATCGGG
GATTTCCATTCGAGAACTAACGGT -> ATTTCCATTCGAGAACTAACGGTG
AAAAGCTAAGGCTTTTCGATACGT -> AAAGCTAAGGCTTTTCGATACGTC
ATCAATTCCCGCTCTTAAACCGCA -> TCAATTCCCGCTCTTAAACCGCAG
TAAACCGCAGTTTATTGTATTCAG -> AAACCGCAGTTTATTGTATTCAGT
TATGGTATATGTGCGGGTCATCGC -> ATGGTATATGTGCGGGTCATCGCA
ATCGGGGATGACTCCGGTTTGTGA -> TCGGGGATGACTCCGGTTTGTGAA
TGCTTCCATAGGCTAAGACGCCGA -> GCTTCCATAGGCTAAGACGCCGAC
GCGAACAACCCCATGAGAATCCGA -> CGAACAACCCCATGAGAATCCGAA
CCTTCGGCGTGTTGGCGGGACAAT -> CTTCGGCGTGTTGGCGGGACAATG
GATCCGCAACGCTCACCCTTAGAT -> ATCCGCAACGCTCACCCTTAGATC
TTAGCGAACAACCCCATGAGAATC -> TAGCGAACAACCCCATGAGAATCC
GAAGAAGAAGAGGTCCTGAAGGCT -> AAGAAGAAGAGGTCCTGAAGGCTC
GCCATAGCTGTGCCTGACAACTGA -> CCATAGCTGTGCCTGACAACTGAC
CATCTCCACCCATGACGATTGTAG -> ATCTCCACCCATGACGATTGTAGA
TGTCAAAGGTTATTACATAAAACG -> GTCAAAGGTTATTACATAAAACGA
CGTCAAAATACACATTCCTATCTA -> GTCAAAATACACATTCCTATCTAT
TTTTTCCCGCGAAGCTCGAATTTC -> TTTTCCCGCGAAGCTCGAATTTCC
GAGTGCTCGTTATCTAAATTCGCC -> AGTGCTCGTTATCTAAATTCGCCC
CAAGACATGGTACTTCCGGTATTT -> AAGACATGGTACTTCCGGTATTTT
ATCTCCGTTGTTCTCGTCGAAGCT -> TCTCCGTTGTTCTCGTCGAAGCTT
TTTCCCAGTTTGGTGTTTTGCCTT -> TTCCCAGTTTGGTGTTTTGCCTTT
GATCTTGGAAAAAATGCACAATCG -> ATCTTGGAAAAAATGCACAATCGA
CTCCACCAGCGATTGCGTGTGACG -> TCCACCAGCGATTGCGTGTGACGT
AGAATGTGTCTGTACTCTTGTCGG -> GAATGTGTCTGTACTCTTGTCGGG
AACGAGAGTTAGTCCCGATATGGG -> ACGAGAGTTAGTCCCGATATGGGT
AAAAATGCTTCGCCTCCGGCTTGG -> AAAATGCTTCGCCTCCGGCTTGGC
GCTGTGGGCGGCTGCATAGCAGAA -> CTGTGGGCGGCTGCATAGCAGAAG
CGTTAAGTATCTAATACGGTCCAC -> GTTAAGTATCTAATACGGTCCACA
CAGATACCAAGAATTGGATCAGAA -> AGATACCAAGAATTGGATCAGAAC
ATTCGCCCGCCTGTCTAGCATGGA -> TTCGCCCGCCTGTCTAGCATGGAC
CGGCCTGCATGGGTGTGACGCTTC -> GGCCTGCATGGGTGTGACGCTTCG
AGTCTCAAATCTGACGCTAGGTCC -> GTCTCAAATCTGACGCTAGGTCCA
TTTAAATCGCCAGAACTCGATTTC -> TTAAATCGCCAGAACTCGATTTCC
TCGGGGATGACTCCGGTTTGTGAA -> CGGGGATGACTCCGGTTTGTGAAA
TGAAATACAATTATTAGTCCCCTT -> GAAATACAATTATTAGTCCCCTTT
CGAACCACAGGTCGGATTATGGTA -> GAACCACAGGTCGGATTATGGTAT
AATCCGTCTCTGTTCTCCAGAAGA -> ATCCGTCTCTGTTCTCCAGAAGAT
CCCTTAGATCAATTCCCGCTCTTA -> CCTTAGATCAATTCCCGCTCTTAA
CCGGCTTGGCGAAAAGCTAAGGCT -> CGGCTTGGCGAAAAGCTAAGGCTT
ACTAGACGCCGGAGGCACGCTGGA -> CTAGACGCCGGAGGCACGCTGGAC
TGTATTCAGTTGTCGGCCTGCATG -> GTATTCAGTTGTCGGCCTGCATGG
CCTCCGGCTTGGCGAAAAGCTAAG -> CTCCGGCTTGGCGAAAAGCTAAGG
CCCGACATTTGGCTTGGCCAGTTG -> CCGACATTTGGCTTGGCCAGTTGC
ATACACATTCCTATCTATTTCACG -> TACACATTCCTATCTATTTCACGA
GAAATACAATTATTAGTCCCCTTT -> AAATACAATTATTAGTCCCCTTTG
AATTATTAGTCCCCTTTGGTAAAT -> ATTATTAGTCCCCTTTGGTAAATC
TCTCAAATCTGACGCTAGGTCCAC -> CTCAAATCTGACGCTAGGTCCACA
CATTGAGATCACACAACATCTCTT -> ATTGAGATCACACAACATCTCTTC
TATGAACCACGACCGCTTGGACTG -> ATGAACCACGACCGCTTGGACTGA
ATGCTTCGCCTCCGGCTTGGCGAA -> TGCTTCGCCTCCGGCTTGGCGAAA
ACGATCTCCGTTGTTCTCGTCGAA -> CGATCTCCGTTGTTCTCGTCGAAG
TTATAAGGTGCATTGAGATCACAC -> TATAAGGTGCATTGAGATCACACA
TCCTCCACCAGCGATTGCGTGTGA -> CCTCCACCAGCGATTGCGTGTGAC
AATGACACGTGTGCCCAATGGGCG -> ATGACACGTGTGCCCAATGGGCGT
ACGCGTTAAGTATCTAATACGGTC -> CGCGTTAAGTATCTAATACGGTCC
AGTTGCATAGGAGGGTATGAACCA -> GTTGCATAGGAGGGTATGAACCAC
ATCACATACACGAAGTTTCGAGGC -> TCACATACACGAAGTTTCGAGGCG
AATCCGAATTGCAACATCGTGACC -> ATCCGAATTGCAACATCGTGACCT
CTCCTCCACCAGCGATTGCGTGTG -> TCCTCCACCAGCGATTGCGTGTGA
AGCGGCTGCTTCCATAGGCTAAGA -> GCGGCTGCTTCCATAGGCTAAGAC
TCCGCAACGCTCACCCTTAGATCA -> CCGCAACGCTCACCCTTAGATCAA
GATGAAATACCATATGTGCTGCGC -> ATGAAATACCATATGTGCTGCGCG
GTTATTACATAAAACGATCTCCGT -> TTATTACATAAAACGATCTCCGTT
GGAAGAAGAAGAGGTCCTGAAGGC -> GAAGAAGAAGAGGTCCTGAAGGCT
GTATTCAGTTGTCGGCCTGCATGG -> TATTCAGTTGTCGGCCTGCATGGG
CGCGCGACTAGACGCCGGAGGCAC -> GCGCGACTAGACGCCGGAGGCACG
CCCCGTGCGATGGGGCTTTAGTTC -> CCCGTGCGATGGGGCTTTAGTTCA
ATTCGAGAACTAACGGTGTGGCGA -> TTCGAGAACTAACGGTGTGGCGAA
CGATTGTAGACGCATCGAGACAAG -> GATTGTAGACGCATCGAGACAAGC
AGACGCCGGAGGCACGCTGGACCC -> GACGCCGGAGGCACGCTGGACCCC
CAAGTATCCACCGTGTCAAAGGTT -> AAGTATCCACCGTGTCAAAGGTTA
GTAGTTATATGGGTCGCCACGTTG -> TAGTTATATGGGTCGCCACGTTGA
TAAGTATCCGTGCTCGATCAACGT -> AAGTATCCGTGCTCGATCAACGTT
TTGGAAAAAATGCACAATCGACCC -> TGGAAAAAATGCACAATCGACCCA
CATGTCTCTCTATATTTAAATCGC -> ATGTCTCTCTATATTTAAATCGCC
CGCAACGCTCACCCTTAGATCAAT -> GCAACGCTCACCCTTAGATCAATT
AGCACTAGCTCCTGCGAACCACAG -> GCACTAGCTCCTGCGAACCACAGG
TTAATAAGAATGTAGTTATATGGG -> TAATAAGAATGTAGTTATATGGGT
ATCTCACTTAGCGAACAACCCCAT -> TCTCACTTAGCGAACAACCCCATG
TTTTCGAGAGAAGAATGTGTCTGT -> TTTCGAGAGAAGAATGTGTCTGTA
CTCCGTTGTTCTCGTCGAAGCTTG -> TCCGTTGTTCTCGTCGAAGCTTGA
CGACATTTGGCTTGGCCAGTTGCA -> GACATTTGGCTTGGCCAGTTGCAT
TTCCCACGGGCTGAATCTCACTTA -> TCCCACGGGCTGAATCTCACTTAG
AGGATGTATGACCATACACGGGAA -> GGATGTATGACCATACACGGGAAA
TCGAGAGAAGAATGTGTCTGTACT -> CGAGAGAAGAATGTGTCTGTACTC
CATCGAGACAAGCATGGAGACTCT -> ATCGAGACAAGCATGGAGACTCTT
ATGAAATACCATATGTGCTGCGCG -> TGAAATACCATATGTGCTGCGCGC
CACGAGTACGTTAACGCTGTAAAA -> ACGAGTACGTTAACGCTGTAAAAT
GCATGGAGACTCTTGGGTCCCCGT -> CATGGAGACTCTTGGGTCCCCGTG
ACACAGATACCAAGAATTGGATCA -> CACAGATACCAAGAATTGGATCAG
TTATCGCCGCATTCACATAAGTCA -> TATCGCCGCATTCACATAAGTCAC
ACTAACGGTGTGGCGAACGTCAAA -> CTAACGGTGTGGCGAACGTCAAAA
AGCATGGACCAACTGCTCATGATG -> GCATGGACCAACTGCTCATGATGA
GCTGGTTGCTCACTTGACATGGAC -> CTGGTTGCTCACTTGACATGGACT
AGAAGAATGTGTCTGTACTCTTGT -> GAAGAATGTGTCTGTACTCTTGTC
CCAATGGGCGTTTCCATGTCTCTC -> CAATGGGCGTTTCCATGTCTCTCT
CTTGACATGGACTAAGTATCCGTG -> TTGACATGGACTAAGTATCCGTGC
TGCGAACCACAGGTCGGATTATGG -> GCGAACCACAGGTCGGATTATGGT
TTCACTCATTAATAAGAATGTAGT -> TCACTCATTAATAAGAATGTAGTT
ACAATGTTGATCCGCAACGCTCAC -> CAATGTTGATCCGCAACGCTCACC
TGAGAATCCGAATTGCAACATCGT -> GAGAATCCGAATTGCAACATCGTG
ATCGAGACAAGCATGGAGACTCTT -> TCGAGACAAGCATGGAGACTCTTG
AATTTCCCAGTTTGGTGTTTTGCC -> ATTTCCCAGTTTGGTGTTTTGCCT
CCTTAGATCAATTCCCGCTCTTAA -> CTTAGATCAATTCCCGCTCTTAAA
TAAGCATCCCACCGACACACTCAG -> AAGCATCCCACCGACACACTCAGT
GGATCAGAACAGCAGCGGACCGGC -> GATCAGAACAGCAGCGGACCGGCA
TCAACGTTTATTGAGTCATTAGCT -> CAACGTTTATTGAGTCATTAGCTG
TACAATAGTCTCCCATTTACGTGT -> ACAATAGTCTCCCATTTACGTGTG
GGAGGTCGCAGCACTAGCTCCTGC -> GAGGTCGCAGCACTAGCTCCTGCG
TGGGTCCTGTCGCCAGGTTCACTC -> GGGTCCTGTCGCCAGGTTCACTCA
CTATTTCACGAGTACGTTAACGCT -> TATTTCACGAGTACGTTAACGCTG
CCGACACACTCAGTGAGTATTACG -> CGACACACTCAGTGAGTATTACGC
TCTAAATTCGCCCGCCTGTCTAGC -> CTAAATTCGCCCGCCTGTCTAGCA
CCAGTTGCATAGGAGGGTATGAAC -> CAGTTGCATAGGAGGGTATGAACC
GTCCCCGTGCGATGGGGCTTTAGT -> TCCCCGTGCGATGGGGCTTTAGTT
GTTCTCGTCGAAGCTTGAGACGAG -> TTCTCGTCGAAGCTTGAGACGAGT
TAATACGGTCCACAAATCGGTTGC -> AATACGGTCCACAAATCGGTTGCT
CGCATTCACATAAGTCACGCGATA -> GCATTCACATAAGTCACGCGATAG
TACTGACCCCTGGACCCGCTACAG -> ACTGACCCCTGGACCCGCTACAGT
AGCAGAAGGTCCTCGGAACTTTAG -> GCAGAAGGTCCTCGGAACTTTAGA
GGCTTGGCCAGTTGCATAGGAGGG -> GCTTGGCCAGTTGCATAGGAGGGT
TGTGAGTTCAACCAAGACATGGTA -> GTGAGTTCAACCAAGACATGGTAC
GTTTATTGTATTCAGTTGTCGGCC -> TTTATTGTATTCAGTTGTCGGCCT
TCAAGTATCCACCGTGTCAAAGGT -> CAAGTATCCACCGTGTCAAAGGTT
ATCCGTCTCTGTTCTCCAGAAGAT -> TCCGTCTCTGTTCTCCAGAAGATC
GTGAAATACAATTATTAGTCCCCT -> TGAAATACAATTATTAGTCCCCTT
GCCGATACTGACCCCTGGACCCGC -> CCGATACTGACCCCTGGACCCGCT
GAGACTCTTGGGTCCCCGTGCGAT -> AGACTCTTGGGTCCCCGTGCGATG
GGACCAACTGCTCATGATGAAATA -> GACCAACTGCTCATGATGAAATAC
GTTGATCCGCAACGCTCACCCTTA -> TTGATCCGCAACGCTCACCCTTAG
GTCCCGATATGGGTCCTGTCGCCA -> TCCCGATATGGGTCCTGTCGCCAG
TTTCGATACGTCGGGCGGGAAATC -> TTCGATACGTCGGGCGGGAAATCC
CGATACTGACCCCTGGACCCGCTA -> GATACTGACCCCTGGACCCGCTAC
ATGACGATTGTAGACGCATCGAGA -> TGACGATTGTAGACGCATCGAGAC
CTTTAGACAAGAAAAATGCTTCGC -> TTTAGACAAGAAAAATGCTTCGCC
CGAGAGTTAGTCCCGATATGGGTC -> GAGAGTTAGTCCCGATATGGGTCC
GCTCGCATTTCGTCCGGCTTACGA -> CTCGCATTTCGTCCGGCTTACGAA
TGACCTGAGTGCTCGTTATCTAAA -> GACCTGAGTGCTCGTTATCTAAAT
ACTGTGAAAATGACACGTGTGCCC -> CTGTGAAAATGACACGTGTGCCCA
TGTGGCTCTAGCACCTCAGTCGAG -> GTGGCTCTAGCACCTCAGTCGAGA
ATTACTAGATAGGGGGCTCCTCCA -> TTACTAGATAGGGGGCTCCTCCAC
CCTTATAACGGCTCTCGAAGAAAC -> CTTATAACGGCTCTCGAAGAAACA
TACGTTAACGCTGTAAAATTCCGT -> ACGTTAACGCTGTAAAATTCCGTA
AGGGGGCTCCTCCACCAGCGATTG -> GGGGGCTCCTCCACCAGCGATTGC
CAATAGTCTCCCATTTACGTGTGT -> AATAGTCTCCCATTTACGTGTGTC
CACATACACGAAGTTTCGAGGCGA -> ACATACACGAAGTTTCGAGGCGAC
TGTGGGCGGCTGCATAGCAGAAGG -> GTGGGCGGCTGCATAGCAGAAGGT
GCGACGTCGTTTACGCCATAGCTG -> CGACGTCGTTTACGCCATAGCTGT
TCGCCAGGTTCACTCATTAATAAG -> CGCCAGGTTCACTCATTAATAAGA
GGTGTCGGCAGTCCTGGACGTCGG -> GTGTCGGCAGTCCTGGACGTCGGA
AGGCTTTTCGATACGTCGGGCGGG -> GGCTTTTCGATACGTCGGGCGGGA
CGCCGACTTTGAACATGTGAGTTC -> GCCGACTTTGAACATGTGAGTTCA
AGTTCAAGTATCCACCGTGTCAAA -> GTTCAAGTATCCACCGTGTCAAAG
CTTTGAAACATGCCAATAGGCACT -> TTTGAAACATGCCAATAGGCACTA
ATACACGAAGTTTCGAGGCGACGT -> TACACGAAGTTTCGAGGCGACGTC
CTCTATATTTAAATCGCCAGAACT -> TCTATATTTAAATCGCCAGAACTC
ATCGACCCACTGTGGCTCTAGCAC -> TCGACCCACTGTGGCTCTAGCACC
TCGCAGCACTAGCTCCTGCGAACC -> CGCAGCACTAGCTCCTGCGAACCA
CAGTTTGGTGTTTTGCCTTTAGCT -> AGTTTGGTGTTTTGCCTTTAGCTC
ATAGGCACTATACCTAGCCCTCTA -> TAGGCACTATACCTAGCCCTCTAT
TGACATGGACTAAGTATCCGTGCT -> GACATGGACTAAGTATCCGTGCTC
TGCTGGTTGCTCACTTGACATGGA -> GCTGGTTGCTCACTTGACATGGAC
TGACTCCGGTTTGTGAAATACAAT -> GACTCCGGTTTGTGAAATACAATT
GCAGTCCTGGACGTCGGACTTTTA -> CAGTCCTGGACGTCGGACTTTTAT
CAGGTTCACTCATTAATAAGAATG -> AGGTTCACTCATTAATAAGAATGT
AAAAATGCACAATCGACCCACTGT -> AAAATGCACAATCGACCCACTGTG
CGAAGTTTCGAGGCGACGTCGTTT -> GAAGTTTCGAGGCGACGTCGTTTA
TCGAGACAAGCATGGAGACTCTTG -> CGAGACAAGCATGGAGACTCTTGG
TCACGAGTACGTTAACGCTGTAAA -> CACGAGTACGTTAACGCTGTAAAA
TTACGCGTTAAGTATCTAATACGG -> TACGCGTTAAGTATCTAATACGGT
GAAGTTTCGAGGCGACGTCGTTTA -> AAGTTTCGAGGCGACGTCGTTTAC
AAGAATTGGATCAGAACAGCAGCG -> AGAATTGGATCAGAACAGCAGCGG
TCACATACACGAAGTTTCGAGGCG -> CACATACACGAAGTTTCGAGGCGA
CTGTGAAAATGACACGTGTGCCCA -> TGTGAAAATGACACGTGTGCCCAA
CCACACGTCGAGACGAATTACTAG -> CACACGTCGAGACGAATTACTAGA
CGTGGCTGTGGGCGGCTGCATAGC -> GTGGCTGTGGGCGGCTGCATAGCA
AACGCTCACCCTTAGATCAATTCC -> ACGCTCACCCTTAGATCAATTCCC
CCAGAACTCGATTTCCATTCGAGA -> CAGAACTCGATTTCCATTCGAGAA
GACGCTAGGTCCACACGTCGAGAC -> ACGCTAGGTCCACACGTCGAGACG
TTAGTTCAAGTATCCACCGTGTCA -> TAGTTCAAGTATCCACCGTGTCAA
AAGCATCCCACCGACACACTCAGT -> AGCATCCCACCGACACACTCAGTG
ACCCCATGAGAATCCGAATTGCAA -> CCCCATGAGAATCCGAATTGCAAC
GCACCTCAGTCGAGAACGTCCACT -> CACCTCAGTCGAGAACGTCCACTT
CGCCGCATTCACATAAGTCACGCG -> GCCGCATTCACATAAGTCACGCGA
TTCACATAAGTCACGCGATAGCGG -> TCACATAAGTCACGCGATAGCGGC
TACACGGGAAACGGGAAAGGGACT -> ACACGGGAAACGGGAAAGGGACTT
ACCCCATCTCCACCCATGACGATT -> CCCCATCTCCACCCATGACGATTG
GTTTTGCCTTTAGCTCAGGATGTA -> TTTTGCCTTTAGCTCAGGATGTAT
GCTGCATAGCAGAAGGTCCTCGGA -> CTGCATAGCAGAAGGTCCTCGGAA
ATGCACAATCGACCCACTGTGGCT -> TGCACAATCGACCCACTGTGGCTC
GACTTACAATAGTCTCCCATTTAC -> ACTTACAATAGTCTCCCATTTACG
ATGGGCGTTTCCATGTCTCTCTAT -> TGGGCGTTTCCATGTCTCTCTATA
GTTGCATAGGAGGGTATGAACCAC -> TTGCATAGGAGGGTATGAACCACG
ACATCGTGACCTGAGTGCTCGTTA -> CATCGTGACCTGAGTGCTCGTTAT
ATTTTTCGAGAGAAGAATGTGTCT -> TTTTTCGAGAGAAGAATGTGTCTG
CCGCTCTTAAACCGCAGTTTATTG -> CGCTCTTAAACCGCAGTTTATTGT
CGCCAGGTTCACTCATTAATAAGA -> GCCAGGTTCACTCATTAATAAGAA
TTTACGCCATAGCTGTGCCTGACA -> TTACGCCATAGCTGTGCCTGACAA
GATTGACGTGGCTGTGGGCGGCTG -> ATTGACGTGGCTGTGGGCGGCTGC
AGATACCAAGAATTGGATCAGAAC -> GATACCAAGAATTGGATCAGAACA
TCCGGCTTACGAAATTTATCGCCG -> CCGGCTTACGAAATTTATCGCCGC
GAGGTGTCGGCAGTCCTGGACGTC -> AGGTGTCGGCAGTCCTGGACGTCG
ACACGAAGTTTCGAGGCGACGTCG -> CACGAAGTTTCGAGGCGACGTCGT
GGCGGTCGAACGAGAGTTAGTCCC -> GCGGTCGAACGAGAGTTAGTCCCG
TGAACCACGACCGCTTGGACTGAA -> GAACCACGACCGCTTGGACTGAAC
TCCGGTTTGTGAAATACAATTATT -> CCGGTTTGTGAAATACAATTATTA
CGGACTTTTATTGCGGCGGTCGAA -> GGACTTTTATTGCGGCGGTCGAAC
GTGTCCTTCGGCGTGTTGGCGGGA -> TGTCCTTCGGCGTGTTGGCGGGAC
ACATAAAACGATCTCCGTTGTTCT -> CATAAAACGATCTCCGTTGTTCTC
CTTGTCGGGTACTTATGGATATGG -> TTGTCGGGTACTTATGGATATGGA
CCGCTACAGTCTCAAATCTGACGC -> CGCTACAGTCTCAAATCTGACGCT
CATATTGAGGTGTCGGCAGTCCTG -> ATATTGAGGTGTCGGCAGTCCTGG
TCAATCCACGATAATCACATACAC -> CAATCCACGATAATCACATACACG
TTACATAAAACGATCTCCGTTGTT -> TACATAAAACGATCTCCGTTGTTC
GACATGGTACTTCCGGTATTTTTC -> ACATGGTACTTCCGGTATTTTTCG
GATACTGACCCCTGGACCCGCTAC -> ATACTGACCCCTGGACCCGCTACA
AGGGACTTACAATAGTCTCCCATT -> GGGACTTACAATAGTCTCCCATTT
TAGACGCATCGAGACAAGCATGGA -> AGACGCATCGAGACAAGCATGGAG
ACATGGTACTTCCGGTATTTTTCG -> CATGGTACTTCCGGTATTTTTCGA
CGCGAAGCTCGAATTTCCCAGTTT -> GCGAAGCTCGAATTTCCCAGTTTG
TCGGGCGGGAAATCCGTCTCTGTT -> CGGGCGGGAAATCCGTCTCTGTTC
TATCGCCGCATTCACATAAGTCAC -> ATCGCCGCATTCACATAAGTCACG
ACATGTGAGTTCAACCAAGACATG -> CATGTGAGTTCAACCAAGACATGG
GTGTTGGCGGGACAATGTTGATCC -> TGTTGGCGGGACAATGTTGATCCG
AATACCATATGTGCTGCGCGCATA -> ATACCATATGTGCTGCGCGCATAT
CCGCCTGTCTAGCATGGACCAACT -> CGCCTGTCTAGCATGGACCAACTG
TGGTTGCTCACTTGACATGGACTA -> GGTTGCTCACTTGACATGGACTAA
GTCGAGAACGTCCACTTTGAAACA -> TCGAGAACGTCCACTTTGAAACAT
ATGCCAATAGGCACTATACCTAGC -> TGCCAATAGGCACTATACCTAGCC
GTATTTTTCGAGAGAAGAATGTGT -> TATTTTTCGAGAGAAGAATGTGTC
TTGTCGGCCTGCATGGGTGTGACG -> TGTCGGCCTGCATGGGTGTGACGC
ATACTGACCCCTGGACCCGCTACA -> TACTGACCCCTGGACCCGCTACAG
TGTGTCCTTCGGCGTGTTGGCGGG -> GTGTCCTTCGGCGTGTTGGCGGGA
AGATTGACGTGGCTGTGGGCGGCT -> GATTGACGTGGCTGTGGGCGGCTG
AGCGTAGAGTTTTTTTTCCCGCGA -> GCGTAGAGTTTTTTTTCCCGCGAA
CTGCATGGGTGTGACGCTTCGCGC -> TGCATGGGTGTGACGCTTCGCGCG
CTGAAGGCTCGCATTTCGTCCGGC -> TGAAGGCTCGCATTTCGTCCGGCT
AGGTGCATTGAGATCACACAACAT -> GGTGCATTGAGATCACACAACATC
TTGATCCGCAACGCTCACCCTTAG -> TGATCCGCAACGCTCACCCTTAGA
GAGGCACGCTGGACCCCATCTCCA -> AGGCACGCTGGACCCCATCTCCAC
AGGTTCACTCATTAATAAGAATGT -> GGTTCACTCATTAATAAGAATGTA
TTATGGTATATGTGCGGGTCATCG -> TATGGTATATGTGCGGGTCATCGC
TAAAATTCCGTATGGGCCGATACT -> AAAATTCCGTATGGGCCGATACTG
AAAACGATCTCCGTTGTTCTCGTC -> AAACGATCTCCGTTGTTCTCGTCG
CCCGATATGGGTCCTGTCGCCAGG -> CCGATATGGGTCCTGTCGCCAGGT
ACAACCCCATGAGAATCCGAATTG -> CAACCCCATGAGAATCCGAATTGC
TAAAACGATCTCCGTTGTTCTCGT -> AAAACGATCTCCGTTGTTCTCGTC
CCACGACCGCTTGGACTGAACCCT -> CACGACCGCTTGGACTGAACCCTT
TGTGTCTGTACTCTTGTCGGGTAC -> GTGTCTGTACTCTTGTCGGGTACT
CGGTGTGGCGAACGTCAAAATACA -> GGTGTGGCGAACGTCAAAATACAC
GTGCATTGAGATCACACAACATCT -> TGCATTGAGATCACACAACATCTC
GAACTAACGGTGTGGCGAACGTCA -> AACTAACGGTGTGGCGAACGTCAA
CGTCGGGCGGGAAATCCGTCTCTG -> GTCGGGCGGGAAATCCGTCTCTGT
GATCAACGTTTATTGAGTCATTAG -> ATCAACGTTTATTGAGTCATTAGC
CCACTTTGAAACATGCCAATAGGC -> CACTTTGAAACATGCCAATAGGCA
CGTCGGACTTTTATTGCGGCGGTC -> GTCGGACTTTTATTGCGGCGGTCG
AAACAGGAGGACGGTTATAAGGTG -> AACAGGAGGACGGTTATAAGGTGC
TTATCTAAATTCGCCCGCCTGTCT -> TATCTAAATTCGCCCGCCTGTCTA
CGGCAGTCCTGGACGTCGGACTTT -> GGCAGTCCTGGACGTCGGACTTTT
CCAGTTTGGTGTTTTGCCTTTAGC -> CAGTTTGGTGTTTTGCCTTTAGCT
GGCGAAAAGCTAAGGCTTTTCGAT -> GCGAAAAGCTAAGGCTTTTCGATA
CAGAACAGCAGCGGACCGGCATGG -> AGAACAGCAGCGGACCGGCATGGG
ACGCCATAGCTGTGCCTGACAACT -> CGCCATAGCTGTGCCTGACAACTG
CCCATGACGATTGTAGACGCATCG -> CCATGACGATTGTAGACGCATCGA
TTCAGTTGTCGGCCTGCATGGGTG -> TCAGTTGTCGGCCTGCATGGGTGT
TCGCCGCATTCACATAAGTCACGC -> CGCCGCATTCACATAAGTCACGCG
GTCGAACGAGAGTTAGTCCCGATA -> TCGAACGAGAGTTAGTCCCGATAT
GATACAGCCCGACATTTGGCTTGG -> ATACAGCCCGACATTTGGCTTGGC
CGCAGCACTAGCTCCTGCGAACCA -> GCAGCACTAGCTCCTGCGAACCAC
TGGCCAGTTGCATAGGAGGGTATG -> GGCCAGTTGCATAGGAGGGTATGA
GTGTCGGCAGTCCTGGACGTCGGA -> TGTCGGCAGTCCTGGACGTCGGAC
CAACACAGATACCAAGAATTGGAT -> AACACAGATACCAAGAATTGGATC
ATTTGGCTTGGCCAGTTGCATAGG -> TTTGGCTTGGCCAGTTGCATAGGA
ATCGCCAGAACTCGATTTCCATTC -> TCGCCAGAACTCGATTTCCATTCG
TGCTGCGCGCATATTGAGGTGTCG -> GCTGCGCGCATATTGAGGTGTCGG
CTTATAACGGCTCTCGAAGAAACA -> TTATAACGGCTCTCGAAGAAACAG
AGTTTTTTTTCCCGCGAAGCTCGA -> GTTTTTTTTCCCGCGAAGCTCGAA
GACGCCGACTTTGAACATGTGAGT -> ACGCCGACTTTGAACATGTGAGTT
CCACGGGCTGAATCTCACTTAGCG -> CACGGGCTGAATCTCACTTAGCGA
AAGGAGGTCGCAGCACTAGCTCCT -> AGGAGGTCGCAGCACTAGCTCCTG
AGAACGTCCACTTTGAAACATGCC -> GAACGTCCACTTTGAAACATGCCA
TCCTGCGAACCACAGGTCGGATTA -> CCTGCGAACCACAGGTCGGATTAT
GTCCACAAATCGGTTGCTGGTTGC -> TCCACAAATCGGTTGCTGGTTGCT
GTCCTGAAGGCTCGCATTTCGTCC -> TCCTGAAGGCTCGCATTTCGTCCG
GGTATTTTTCGAGAGAAGAATGTG -> GTATTTTTCGAGAGAAGAATGTGT
GGTCGAACGAGAGTTAGTCCCGAT -> GTCGAACGAGAGTTAGTCCCGATA
CTAGACGCCGGAGGCACGCTGGAC -> TAGACGCCGGAGGCACGCTGGACC
TGGAGACTCTTGGGTCCCCGTGCG -> GGAGACTCTTGGGTCCCCGTGCGA
CTCCCATTTACGTGTGTCCTTCGG -> TCCCATTTACGTGTGTCCTTCGGC
TAACGGTGTGGCGAACGTCAAAAT -> AACGGTGTGGCGAACGTCAAAATA
CGTGTGACGTTTCCCACGGGCTGA -> GTGTGACGTTTCCCACGGGCTGAA
CGGAGGCACGCTGGACCCCATCTC -> GGAGGCACGCTGGACCCCATCTCC
CGGTATTTTTCGAGAGAAGAATGT -> GGTATTTTTCGAGAGAAGAATGTG
GCATAGCAGAAGGTCCTCGGAACT -> CATAGCAGAAGGTCCTCGGAACTT
AAATCAATCCACGATAATCACATA -> AATCAATCCACGATAATCACATAC
CGGGCTGAATCTCACTTAGCGAAC -> GGGCTGAATCTCACTTAGCGAACA
GCACCATAGCACTACCCGCTAACC -> CACCATAGCACTACCCGCTAACCC
CCGCAGTTTATTGTATTCAGTTGT -> CGCAGTTTATTGTATTCAGTTGTC
CATTTACGTGTGTCCTTCGGCGTG -> ATTTACGTGTGTCCTTCGGCGTGT
TTGGCTTGGCCAGTTGCATAGGAG -> TGGCTTGGCCAGTTGCATAGGAGG
CTCGAAGAAACAGGAGGACGGTTA -> TCGAAGAAACAGGAGGACGGTTAT
ATCCGAATTGCAACATCGTGACCT -> TCCGAATTGCAACATCGTGACCTG
AGTCTCCCATTTACGTGTGTCCTT -> GTCTCCCATTTACGTGTGTCCTTC
GATCACACAACATCTCTTCTCTTC -> ATCACACAACATCTCTTCTCTTCT
GTCACGCGATAGCGGCTGCTTCCA -> TCACGCGATAGCGGCTGCTTCCAT
GTAGAGTTTTTTTTCCCGCGAAGC -> TAGAGTTTTTTTTCCCGCGAAGCT
TCGGCCTGCATGGGTGTGACGCTT -> CGGCCTGCATGGGTGTGACGCTTC
AGAAAAATGCTTCGCCTCCGGCTT -> GAAAAATGCTTCGCCTCCGGCTTG
TAGCGAACAACCCCATGAGAATCC -> AGCGAACAACCCCATGAGAATCCG
TTGGCGAAAAGCTAAGGCTTTTCG -> TGGCGAAAAGCTAAGGCTTTTCGA
TGAGGTGTCGGCAGTCCTGGACGT -> GAGGTGTCGGCAGTCCTGGACGTC
ACTGACCCCTGGACCCGCTACAGT -> CTGACCCCTGGACCCGCTACAGTC
AAGGTGCATTGAGATCACACAACA -> AGGTGCATTGAGATCACACAACAT
GGTTGCTCACTTGACATGGACTAA -> GTTGCTCACTTGACATGGACTAAG
CTCGCATTTCGTCCGGCTTACGAA -> TCGCATTTCGTCCGGCTTACGAAA
ACTGTGGCTCTAGCACCTCAGTCG -> CTGTGGCTCTAGCACCTCAGTCGA
TGGGCGATACAGCCCGACATTTGG -> GGGCGATACAGCCCGACATTTGGC
AAGAGGTCCTGAAGGCTCGCATTT -> AGAGGTCCTGAAGGCTCGCATTTC
TCGTCGAAGCTTGAGACGAGTCTG -> CGTCGAAGCTTGAGACGAGTCTGA
GCGTGTGACGTTTCCCACGGGCTG -> CGTGTGACGTTTCCCACGGGCTGA
ATGTGTCTGTACTCTTGTCGGGTA -> TGTGTCTGTACTCTTGTCGGGTAC
TTAGCTGGGAAGAAGAAGAGGTCC -> TAGCTGGGAAGAAGAAGAGGTCCT
GTGCGGGTCATCGCACCATAGCAC -> TGCGGGTCATCGCACCATAGCACT
GCTCGTTATCTAAATTCGCCCGCC -> CTCGTTATCTAAATTCGCCCGCCT
GACTTTAAGCATCCCACCGACACA -> ACTTTAAGCATCCCACCGACACAC
TACTTATGGATATGGACGAGATTG -> ACTTATGGATATGGACGAGATTGA
ACCATACACGGGAAACGGGAAAGG -> CCATACACGGGAAACGGGAAAGGG
CCCCATCTCCACCCATGACGATTG -> CCCATCTCCACCCATGACGATTGT
AAATACCATATGTGCTGCGCGCAT -> AATACCATATGTGCTGCGCGCATA
ATTTCGTCCGGCTTACGAAATTTA -> TTTCGTCCGGCTTACGAAATTTAT
TTTCGAGGCGACGTCGTTTACGCC -> TTCGAGGCGACGTCGTTTACGCCA
CCCACTGTGGCTCTAGCACCTCAG -> CCACTGTGGCTCTAGCACCTCAGT
TGCTCGTTATCTAAATTCGCCCGC -> GCTCGTTATCTAAATTCGCCCGCC
ATCCACGATAATCACATACACGAA -> TCCACGATAATCACATACACGAAG
ATTTACGTGTGTCCTTCGGCGTGT -> TTTACGTGTGTCCTTCGGCGTGTT
ATGGACGAGATTGACGTGGCTGTG -> TGGACGAGATTGACGTGGCTGTGG
CAGCCCGACATTTGGCTTGGCCAG -> AGCCCGACATTTGGCTTGGCCAGT
AGACAAGAAAAATGCTTCGCCTCC -> GACAAGAAAAATGCTTCGCCTCCG
GGACTAAGTATCCGTGCTCGATCA -> GACTAAGTATCCGTGCTCGATCAA
GGATGTATGACCATACACGGGAAA -> GATGTATGACCATACACGGGAAAC
GCAACATCGTGACCTGAGTGCTCG -> CAACATCGTGACCTGAGTGCTCGT
GCTACAGTCTCAAATCTGACGCTA -> CTACAGTCTCAAATCTGACGCTAG
CTCGTTATCTAAATTCGCCCGCCT -> TCGTTATCTAAATTCGCCCGCCTG
GAAGAAGAGGTCCTGAAGGCTCGC -> AAGAAGAGGTCCTGAAGGCTCGCA
ATACCTAGCCCTCTATCGGGGATG -> TACCTAGCCCTCTATCGGGGATGA
TCGGGTGATTGGTAGCGTAGAGTT -> CGGGTGATTGGTAGCGTAGAGTTT
GGCGTGTTGGCGGGACAATGTTGA -> GCGTGTTGGCGGGACAATGTTGAT
ATCCGCAACGCTCACCCTTAGATC -> TCCGCAACGCTCACCCTTAGATCA
AAGGTCCTCGGAACTTTAGACAAG -> AGGTCCTCGGAACTTTAGACAAGA
TATGGACGAGATTGACGTGGCTGT -> ATGGACGAGATTGACGTGGCTGTG
GGACCCGCTACAGTCTCAAATCTG -> GACCCGCTACAGTCTCAAATCTGA
CGCGACTAGACGCCGGAGGCACGC -> GCGACTAGACGCCGGAGGCACGCT
GACTTTGAACATGTGAGTTCAACC -> ACTTTGAACATGTGAGTTCAACCA
TTCAAGTATCCACCGTGTCAAAGG -> TCAAGTATCCACCGTGTCAAAGGT
TCTTGGAAAAAATGCACAATCGAC -> CTTGGAAAAAATGCACAATCGACC
AAAATACACATTCCTATCTATTTC -> AAATACACATTCCTATCTATTTCA
TCGATTTCCATTCGAGAACTAACG -> CGATTTCCATTCGAGAACTAACGG
CTGAATCTCACTTAGCGAACAACC -> TGAATCTCACTTAGCGAACAACCC
CGTGTGCCCAATGGGCGTTTCCAT -> GTGTGCCCAATGGGCGTTTCCATG
AACGTCCACTTTGAAACATGCCAA -> ACGTCCACTTTGAAACATGCCAAT
TGCTTCGCCTCCGGCTTGGCGAAA -> GCTTCGCCTCCGGCTTGGCGAAAA
CTAGATAGGGGGCTCCTCCACCAG -> TAGATAGGGGGCTCCTCCACCAGC
AATCACATACACGAAGTTTCGAGG -> ATCACATACACGAAGTTTCGAGGC
GGGCTCCTCCACCAGCGATTGCGT -> GGCTCCTCCACCAGCGATTGCGTG
CTCACTTGACATGGACTAAGTATC -> TCACTTGACATGGACTAAGTATCC
ACAACATCTCTTCTCTTCTTGGGT -> CAACATCTCTTCTCTTCTTGGGTG
GGTCCTGTCGCCAGGTTCACTCAT -> GTCCTGTCGCCAGGTTCACTCATT
TCGGTTGCTGGTTGCTCACTTGAC -> CGGTTGCTGGTTGCTCACTTGACA
AATGCTTCGCCTCCGGCTTGGCGA -> ATGCTTCGCCTCCGGCTTGGCGAA
TATAAGGTGCATTGAGATCACACA -> ATAAGGTGCATTGAGATCACACAA
GTAAATCAATCCACGATAATCACA -> TAAATCAATCCACGATAATCACAT
GGGCGGGAAATCCGTCTCTGTTCT -> GGCGGGAAATCCGTCTCTGTTCTC
ACTAGATAGGGGGCTCCTCCACCA -> CTAGATAGGGGGCTCCTCCACCAG
CTATACCTAGCCCTCTATCGGGGA -> TATACCTAGCCCTCTATCGGGGAT
TAAGAATGTAGTTATATGGGTCGC -> AAGAATGTAGTTATATGGGTCGCC
CGGGTCATCGCACCATAGCACTAC -> GGGTCATCGCACCATAGCACTACC
ACTTTAAGCATCCCACCGACACAC -> CTTTAAGCATCCCACCGACACACT
GGCTTTTCGATACGTCGGGCGGGA -> GCTTTTCGATACGTCGGGCGGGAA
CGGGCGGGAAATCCGTCTCTGTTC -> GGGCGGGAAATCCGTCTCTGTTCT
CCGCAACACAGATACCAAGAATTG -> CGCAACACAGATACCAAGAATTGG
GTATTACGCGTTAAGTATCTAATA -> TATTACGCGTTAAGTATCTAATAC
TTGGACTGAACCCTTATAACGGCT -> TGGACTGAACCCTTATAACGGCTC
ATTGAGTCATTAGCTGGGAAGAAG -> TTGAGTCATTAGCTGGGAAGAAGA
CAAGCATGGAGACTCTTGGGTCCC -> AAGCATGGAGACTCTTGGGTCCCC
TTGCTGGTTGCTCACTTGACATGG -> TGCTGGTTGCTCACTTGACATGGA
GCCGACTTTGAACATGTGAGTTCA -> CCGACTTTGAACATGTGAGTTCAA
AGCTAAGGCTTTTCGATACGTCGG -> GCTAAGGCTTTTCGATACGTCGGG
TCCCCGTGCGATGGGGCTTTAGTT -> CCCCGTGCGATGGGGCTTTAGTTC
TTTCGTCCGGCTTACGAAATTTAT -> TTCGTCCGGCTTACGAAATTTATC
GGTAGCGTAGAGTTTTTTTTCCCG -> GTAGCGTAGAGTTTTTTTTCCCGC
AATGGGCGTTTCCATGTCTCTCTA -> ATGGGCGTTTCCATGTCTCTCTAT
CGCATTTCGTCCGGCTTACGAAAT -> GCATTTCGTCCGGCTTACGAAATT
TCTCACTTAGCGAACAACCCCATG -> CTCACTTAGCGAACAACCCCATGA
CCTGTCTAGCATGGACCAACTGCT -> CTGTCTAGCATGGACCAACTGCTC
CAACGCTCACCCTTAGATCAATTC -> AACGCTCACCCTTAGATCAATTCC
TTTGTGAAATACAATTATTAGTCC -> TTGTGAAATACAATTATTAGTCCC
GGTCCACAAATCGGTTGCTGGTTG -> GTCCACAAATCGGTTGCTGGTTGC
CACTTGACATGGACTAAGTATCCG -> ACTTGACATGGACTAAGTATCCGT
GGACGAGATTGACGTGGCTGTGGG -> GACGAGATTGACGTGGCTGTGGGC
CAGCGGACCGGCATGGGCGATACA -> AGCGGACCGGCATGGGCGATACAG
AAGGGACTTACAATAGTCTCCCAT -> AGGGACTTACAATAGTCTCCCATT
AACGTTTATTGAGTCATTAGCTGG -> ACGTTTATTGAGTCATTAGCTGGG
TGCGGCGGTCGAACGAGAGTTAGT -> GCGGCGGTCGAACGAGAGTTAGTC
AGATCTCGTGGTTCGGGTGATTGG -> GATCTCGTGGTTCGGGTGATTGGT
AAAGGTTATTACATAAAACGATCT -> AAGGTTATTACATAAAACGATCTC
AATCTCACTTAGCGAACAACCCCA -> ATCTCACTTAGCGAACAACCCCAT
CTCAGGATGTATGACCATACACGG -> TCAGGATGTATGACCATACACGGG
CAGGTCGGATTATGGTATATGTGC -> AGGTCGGATTATGGTATATGTGCG
CGTTTATTGAGTCATTAGCTGGGA -> GTTTATTGAGTCATTAGCTGGGAA
AGTATCCGTGCTCGATCAACGTTT -> GTATCCGTGCTCGATCAACGTTTA
CAGCGATTGCGTGTGACGTTTCCC -> AGCGATTGCGTGTGACGTTTCCCA
CACGTGTGCCCAATGGGCGTTTCC -> ACGTGTGCCCAATGGGCGTTTCCA
GTCGGCCTGCATGGGTGTGACGCT -> TCGGCCTGCATGGGTGTGACGCTT
GCGAACCACAGGTCGGATTATGGT -> CGAACCACAGGTCGGATTATGGTA
TTGAGTCATTAGCTGGGAAGAAGA -> TGAGTCATTAGCTGGGAAGAAGAA
CCGTGCTCGATCAACGTTTATTGA -> CGTGCTCGATCAACGTTTATTGAG
CCAGAAGATCTCGTGGTTCGGGTG -> CAGAAGATCTCGTGGTTCGGGTGA
CCGCGAAGCTCGAATTTCCCAGTT -> CGCGAAGCTCGAATTTCCCAGTTT
TCATGATGAAATACCATATGTGCT -> CATGATGAAATACCATATGTGCTG
TCTGACGCTAGGTCCACACGTCGA -> CTGACGCTAGGTCCACACGTCGAG
GAAAAGCTAAGGCTTTTCGATACG -> AAAAGCTAAGGCTTTTCGATACGT
AATCAATCCACGATAATCACATAC -> ATCAATCCACGATAATCACATACA
CGTCCACTTTGAAACATGCCAATA -> GTCCACTTTGAAACATGCCAATAG
TATTAGTCCCCTTTGGTAAATCAA -> ATTAGTCCCCTTTGGTAAATCAAT
GAACGTCAAAATACACATTCCTAT -> AACGTCAAAATACACATTCCTATC
CGCATATTGAGGTGTCGGCAGTCC -> GCATATTGAGGTGTCGGCAGTCCT
CCAACTGCTCATGATGAAATACCA -> CAACTGCTCATGATGAAATACCAT
ATTGCAACATCGTGACCTGAGTGC -> TTGCAACATCGTGACCTGAGTGCT
AGGTCCTGAAGGCTCGCATTTCGT -> GGTCCTGAAGGCTCGCATTTCGTC
AGTCCCGATATGGGTCCTGTCGCC -> GTCCCGATATGGGTCCTGTCGCCA
GTTTCGAGGCGACGTCGTTTACGC -> TTTCGAGGCGACGTCGTTTACGCC
AGTCCCCTTTGGTAAATCAATCCA -> GTCCCCTTTGGTAAATCAATCCAC
TTGTTCTCGTCGAAGCTTGAGACG -> TGTTCTCGTCGAAGCTTGAGACGA
TTGTATTCAGTTGTCGGCCTGCAT -> TGTATTCAGTTGTCGGCCTGCATG
GAGGGTATGAACCACGACCGCTTG -> AGGGTATGAACCACGACCGCTTGG
TTTATTGTATTCAGTTGTCGGCCT -> TTATTGTATTCAGTTGTCGGCCTG
CGCCTCCGGCTTGGCGAAAAGCTA -> GCCTCCGGCTTGGCGAAAAGCTAA
CTCTTGGGTCCCCGTGCGATGGGG -> TCTTGGGTCCCCGTGCGATGGGGC
CCCGCTAACCCGCAACACAGATAC -> CCGCTAACCCGCAACACAGATACC
TGCATGGGTGTGACGCTTCGCGCG -> GCATGGGTGTGACGCTTCGCGCGA
AGAGGTCCTGAAGGCTCGCATTTC -> GAGGTCCTGAAGGCTCGCATTTCG
ATGGGCCGATACTGACCCCTGGAC -> TGGGCCGATACTGACCCCTGGACC
CCGATACTGACCCCTGGACCCGCT -> CGATACTGACCCCTGGACCCGCTA
TCAGTGAGTATTACGCGTTAAGTA -> CAGTGAGTATTACGCGTTAAGTAT
ACGAGATTGACGTGGCTGTGGGCG -> CGAGATTGACGTGGCTGTGGGCGG
TGAGTTCAACCAAGACATGGTACT -> GAGTTCAACCAAGACATGGTACTT
TCCCCTTTGGTAAATCAATCCACG -> CCCCTTTGGTAAATCAATCCACGA
GCCACGTTGAAGGAGGTCGCAGCA -> CCACGTTGAAGGAGGTCGCAGCAC
TCTCGTGGTTCGGGTGATTGGTAG -> CTCGTGGTTCGGGTGATTGGTAGC
ACCGCAGTTTATTGTATTCAGTTG -> CCGCAGTTTATTGTATTCAGTTGT
AAATGCTTCGCCTCCGGCTTGGCG -> AATGCTTCGCCTCCGGCTTGGCGA
TGAGAGACTGTGAAAATGACACGT -> GAGAGACTGTGAAAATGACACGTG
TACTCTTGTCGGGTACTTATGGAT -> ACTCTTGTCGGGTACTTATGGATA
AGCTTGAGACGAGTCTGAGAGACT -> GCTTGAGACGAGTCTGAGAGACTG
ATGTCTCTCTATATTTAAATCGCC -> TGTCTCTCTATATTTAAATCGCCA
GCGGCTGCATAGCAGAAGGTCCTC -> CGGCTGCATAGCAGAAGGTCCTCG
GAATTTCCCAGTTTGGTGTTTTGC -> AATTTCCCAGTTTGGTGTTTTGCC
TCGTTTACGCCATAGCTGTGCCTG -> CGTTTACGCCATAGCTGTGCCTGA
TCCATGTCTCTCTATATTTAAATC -> CCATGTCTCTCTATATTTAAATCG
ACGATTGTAGACGCATCGAGACAA -> CGATTGTAGACGCATCGAGACAAG
TTTTATTGCGGCGGTCGAACGAGA -> TTTATTGCGGCGGTCGAACGAGAG
GAAACAGGAGGACGGTTATAAGGT -> AAACAGGAGGACGGTTATAAGGTG
CTCGATCAACGTTTATTGAGTCAT -> TCGATCAACGTTTATTGAGTCATT
CGAGACGAATTACTAGATAGGGGG -> GAGACGAATTACTAGATAGGGGGC
GCGAACGTCAAAATACACATTCCT -> CGAACGTCAAAATACACATTCCTA
CATGGTACTTCCGGTATTTTTCGA -> ATGGTACTTCCGGTATTTTTCGAG
TGTGCCCAATGGGCGTTTCCATGT -> GTGCCCAATGGGCGTTTCCATGTC
TTTAGACAAGAAAAATGCTTCGCC -> TTAGACAAGAAAAATGCTTCGCCT
TTCGAGAACTAACGGTGTGGCGAA -> TCGAGAACTAACGGTGTGGCGAAC
GATGGGGCTTTAGTTCAAGTATCC -> ATGGGGCTTTAGTTCAAGTATCCA
TTGGCCAGTTGCATAGGAGGGTAT -> TGGCCAGTTGCATAGGAGGGTATG
GCATCGAGACAAGCATGGAGACTC -> CATCGAGACAAGCATGGAGACTCT
CAATTATTAGTCCCCTTTGGTAAA -> AATTATTAGTCCCCTTTGGTAAAT
ACCCGCTACAGTCTCAAATCTGAC -> CCCGCTACAGTCTCAAATCTGACG
TGCATAGGAGGGTATGAACCACGA -> GCATAGGAGGGTATGAACCACGAC
ATAGGGGGCTCCTCCACCAGCGAT -> TAGGGGGCTCCTCCACCAGCGATT
ACAAGAAAAATGCTTCGCCTCCGG -> CAAGAAAAATGCTTCGCCTCCGGC
ACGTGTGCCCAATGGGCGTTTCCA -> CGTGTGCCCAATGGGCGTTTCCAT
TCTTAAACCGCAGTTTATTGTATT -> CTTAAACCGCAGTTTATTGTATTC
GGCTCCTCCACCAGCGATTGCGTG -> GCTCCTCCACCAGCGATTGCGTGT
CACCCTTAGATCAATTCCCGCTCT -> ACCCTTAGATCAATTCCCGCTCTT
TATGTGCGGGTCATCGCACCATAG -> ATGTGCGGGTCATCGCACCATAGC
AGAAGAAGAGGTCCTGAAGGCTCG -> GAAGAAGAGGTCCTGAAGGCTCGC
GAATGTGTCTGTACTCTTGTCGGG -> AATGTGTCTGTACTCTTGTCGGGT
ATCAGAACAGCAGCGGACCGGCAT -> TCAGAACAGCAGCGGACCGGCATG
GCGATACAGCCCGACATTTGGCTT -> CGATACAGCCCGACATTTGGCTTG
ATGATGAAATACCATATGTGCTGC -> TGATGAAATACCATATGTGCTGCG
GACGAATTACTAGATAGGGGGCTC -> ACGAATTACTAGATAGGGGGCTCC
ACCAACTGCTCATGATGAAATACC -> CCAACTGCTCATGATGAAATACCA
ATTGGTAGCGTAGAGTTTTTTTTC -> TTGGTAGCGTAGAGTTTTTTTTCC
ACGAGTACGTTAACGCTGTAAAAT -> CGAGTACGTTAACGCTGTAAAATT
ATCCACCGTGTCAAAGGTTATTAC -> TCCACCGTGTCAAAGGTTATTACA
CTTAGCGAACAACCCCATGAGAAT -> TTAGCGAACAACCCCATGAGAATC
ACTTAGCGAACAACCCCATGAGAA -> CTTAGCGAACAACCCCATGAGAAT
CTCGAATTTCCCAGTTTGGTGTTT -> TCGAATTTCCCAGTTTGGTGTTTT
GCGCGACTAGACGCCGGAGGCACG -> CGCGACTAGACGCCGGAGGCACGC
GACCCGCTACAGTCTCAAATCTGA -> ACCCGCTACAGTCTCAAATCTGAC
GGCTTTAGTTCAAGTATCCACCGT -> GCTTTAGTTCAAGTATCCACCGTG
GGGTGATTGGTAGCGTAGAGTTTT -> GGTGATTGGTAGCGTAGAGTTTTT
ACGGTCCACAAATCGGTTGCTGGT -> CGGTCCACAAATCGGTTGCTGGTT
CCTTTAGCTCAGGATGTATGACCA -> CTTTAGCTCAGGATGTATGACCAT
GTTTTTTTTCCCGCGAAGCTCGAA -> TTTTTTTTCCCGCGAAGCTCGAAT
CATAAGTCACGCGATAGCGGCTGC -> ATAAGTCACGCGATAGCGGCTGCT
CGATTTCCATTCGAGAACTAACGG -> GATTTCCATTCGAGAACTAACGGT
TAAGTATCTAATACGGTCCACAAA -> AAGTATCTAATACGGTCCACAAAT
GCGGGACAATGTTGATCCGCAACG -> CGGGACAATGTTGATCCGCAACGC
GTTTCCCACGGGCTGAATCTCACT -> TTTCCCACGGGCTGAATCTCACTT
ATCAACGTTTATTGAGTCATTAGC -> TCAACGTTTATTGAGTCATTAGCT
AGGACGGTTATAAGGTGCATTGAG -> GGACGGTTATAAGGTGCATTGAGA
CCACCAGCGATTGCGTGTGACGTT -> CACCAGCGATTGCGTGTGACGTTT
CCATAGCACTACCCGCTAACCCGC -> CATAGCACTACCCGCTAACCCGCA
TTGGATCAGAACAGCAGCGGACCG -> TGGATCAGAACAGCAGCGGACCGG
ATTCAGTTGTCGGCCTGCATGGGT -> TTCAGTTGTCGGCCTGCATGGGTG
CTGCTTCCATAGGCTAAGACGCCG -> TGCTTCCATAGGCTAAGACGCCGA
AAGAAACAGGAGGACGGTTATAAG -> AGAAACAGGAGGACGGTTATAAGG
CCCATGAGAATCCGAATTGCAACA -> CCATGAGAATCCGAATTGCAACAT
AATTCGCCCGCCTGTCTAGCATGG -> ATTCGCCCGCCTGTCTAGCATGGA
ACATGCCAATAGGCACTATACCTA -> CATGCCAATAGGCACTATACCTAG
CGTTTACGCCATAGCTGTGCCTGA -> GTTTACGCCATAGCTGTGCCTGAC
CGTGCTCGATCAACGTTTATTGAG -> GTGCTCGATCAACGTTTATTGAGT
ACGTGTGTCCTTCGGCGTGTTGGC -> CGTGTGTCCTTCGGCGTGTTGGCG
CCATATGTGCTGCGCGCATATTGA -> CATATGTGCTGCGCGCATATTGAG
GGGTACTTATGGATATGGACGAGA -> GGTACTTATGGATATGGACGAGAT
TGGTGTTTTGCCTTTAGCTCAGGA -> GGTGTTTTGCCTTTAGCTCAGGAT
TACGAAATTTATCGCCGCATTCAC -> ACGAAATTTATCGCCGCATTCACA
AGAAACAGGAGGACGGTTATAAGG -> GAAACAGGAGGACGGTTATAAGGT
TGCTCACTTGACATGGACTAAGTA -> GCTCACTTGACATGGACTAAGTAT
TTTTCGATACGTCGGGCGGGAAAT -> TTTCGATACGTCGGGCGGGAAATC
CGAAAAGCTAAGGCTTTTCGATAC -> GAAAAGCTAAGGCTTTTCGATACG
TGTGGCGAACGTCAAAATACACAT -> GTGGCGAACGTCAAAATACACATT
TGCGCGCATATTGAGGTGTCGGCA -> GCGCGCATATTGAGGTGTCGGCAG
GCTAAGGCTTTTCGATACGTCGGG -> CTAAGGCTTTTCGATACGTCGGGC
ATTCCCGCTCTTAAACCGCAGTTT -> TTCCCGCTCTTAAACCGCAGTTTA
CGATCTCCGTTGTTCTCGTCGAAG -> GATCTCCGTTGTTCTCGTCGAAGC
TGACGTGGCTGTGGGCGGCTGCAT -> GACGTGGCTGTGGGCGGCTGCATA
GCTCTCGAAGAAACAGGAGGACGG -> CTCTCGAAGAAACAGGAGGACGGT
TAGCATGGACCAACTGCTCATGAT -> AGCATGGACCAACTGCTCATGATG
GCCCGACATTTGGCTTGGCCAGTT -> CCCGACATTTGGCTTGGCCAGTTG
TGCGATGGGGCTTTAGTTCAAGTA -> GCGATGGGGCTTTAGTTCAAGTAT
ATGGGTCGCCACGTTGAAGGAGGT -> TGGGTCGCCACGTTGAAGGAGGTC
TCCGTTGTTCTCGTCGAAGCTTGA -> CCGTTGTTCTCGTCGAAGCTTGAG
ATTGACGTGGCTGTGGGCGGCTGC -> TTGACGTGGCTGTGGGCGGCTGCA
CGAACGTCAAAATACACATTCCTA -> GAACGTCAAAATACACATTCCTAT
CCAAGAATTGGATCAGAACAGCAG -> CAAGAATTGGATCAGAACAGCAGC
TCCACCCATGACGATTGTAGACGC -> CCACCCATGACGATTGTAGACGCA
CCACCGACACACTCAGTGAGTATT -> CACCGACACACTCAGTGAGTATTA
CATAGGCTAAGACGCCGACTTTGA -> ATAGGCTAAGACGCCGACTTTGAA
GTGGCTGTGGGCGGCTGCATAGCA -> TGGCTGTGGGCGGCTGCATAGCAG
GCCAGAACTCGATTTCCATTCGAG -> CCAGAACTCGATTTCCATTCGAGA
CTTGAGACGAGTCTGAGAGACTGT -> TTGAGACGAGTCTGAGAGACTGTG
AAGCTTGAGACGAGTCTGAGAGAC -> AGCTTGAGACGAGTCTGAGAGACT
CAAATCTGACGCTAGGTCCACACG -> AAATCTGACGCTAGGTCCACACGT
CGATTGCGTGTGACGTTTCCCACG -> GATTGCGTGTGACGTTTCCCACGG
CACATTCCTATCTATTTCACGAGT -> ACATTCCTATCTATTTCACGAGTA
GATATGGGTCCTGTCGCCAGGTTC -> ATATGGGTCCTGTCGCCAGGTTCA
TTAACGCTGTAAAATTCCGTATGG -> TAACGCTGTAAAATTCCGTATGGG
TAAATCGCCAGAACTCGATTTCCA -> AAATCGCCAGAACTCGATTTCCAT
GAAGATCTCGTGGTTCGGGTGATT -> AAGATCTCGTGGTTCGGGTGATTG
GCAACGCTCACCCTTAGATCAATT -> CAACGCTCACCCTTAGATCAATTC
CTTGGCGAAAAGCTAAGGCTTTTC -> TTGGCGAAAAGCTAAGGCTTTTCG
CCAATAGGCACTATACCTAGCCCT -> CAATAGGCACTATACCTAGCCCTC
GACCCCTGGACCCGCTACAGTCTC -> ACCCCTGGACCCGCTACAGTCTCA
TATATGTGCGGGTCATCGCACCAT -> ATATGTGCGGGTCATCGCACCATA
TCATCGCACCATAGCACTACCCGC -> CATCGCACCATAGCACTACCCGCT
GGTGCATTGAGATCACACAACATC -> GTGCATTGAGATCACACAACATCT
GGTCGCCACGTTGAAGGAGGTCGC -> GTCGCCACGTTGAAGGAGGTCGCA
TAGCTGGGAAGAAGAAGAGGTCCT -> AGCTGGGAAGAAGAAGAGGTCCTG
AACGGCTCTCGAAGAAACAGGAGG -> ACGGCTCTCGAAGAAACAGGAGGA
CCCGTGCGATGGGGCTTTAGTTCA -> CCGTGCGATGGGGCTTTAGTTCAA
CCCCTTTGGTAAATCAATCCACGA -> CCCTTTGGTAAATCAATCCACGAT
GCGGGAAATCCGTCTCTGTTCTCC -> CGGGAAATCCGTCTCTGTTCTCCA
GTTTCCATGTCTCTCTATATTTAA -> TTTCCATGTCTCTCTATATTTAAA
CACCATAGCACTACCCGCTAACCC -> ACCATAGCACTACCCGCTAACCCG
GTCGGATTATGGTATATGTGCGGG -> TCGGATTATGGTATATGTGCGGGT
GGGTCATCGCACCATAGCACTACC -> GGTCATCGCACCATAGCACTACCC
CCACAAATCGGTTGCTGGTTGCTC -> CACAAATCGGTTGCTGGTTGCTCA
CATAGCACTACCCGCTAACCCGCA -> ATAGCACTACCCGCTAACCCGCAA
GTGCCCAATGGGCGTTTCCATGTC -> TGCCCAATGGGCGTTTCCATGTCT
GATATGGACGAGATTGACGTGGCT -> ATATGGACGAGATTGACGTGGCTG
ACGGGCTGAATCTCACTTAGCGAA -> CGGGCTGAATCTCACTTAGCGAAC
ATGGACCAACTGCTCATGATGAAA -> TGGACCAACTGCTCATGATGAAAT
CACACGTCGAGACGAATTACTAGA -> ACACGTCGAGACGAATTACTAGAT
ATCTATTTCACGAGTACGTTAACG -> TCTATTTCACGAGTACGTTAACGC
GCTGCTTCCATAGGCTAAGACGCC -> CTGCTTCCATAGGCTAAGACGCCG
CTTTGAACATGTGAGTTCAACCAA -> TTTGAACATGTGAGTTCAACCAAG
CATTCCTATCTATTTCACGAGTAC -> ATTCCTATCTATTTCACGAGTACG
CCGAATTGCAACATCGTGACCTGA -> CGAATTGCAACATCGTGACCTGAG
GTGGCGAACGTCAAAATACACATT -> TGGCGAACGTCAAAATACACATTC
TGCTCGATCAACGTTTATTGAGTC -> GCTCGATCAACGTTTATTGAGTCA
GTCCTCGGAACTTTAGACAAGAAA -> TCCTCGGAACTTTAGACAAGAAAA
GCTCACCCTTAGATCAATTCCCGC -> CTCACCCTTAGATCAATTCCCGCT
TGATCCGCAACGCTCACCCTTAGA -> GATCCGCAACGCTCACCCTTAGAT
AGAACAGCAGCGGACCGGCATGGG -> GAACAGCAGCGGACCGGCATGGGC
GAACTCGATTTCCATTCGAGAACT -> AACTCGATTTCCATTCGAGAACTA
GTGTGGCGAACGTCAAAATACACA -> TGTGGCGAACGTCAAAATACACAT
GGCGATACAGCCCGACATTTGGCT -> GCGATACAGCCCGACATTTGGCTT
CGGTCGAACGAGAGTTAGTCCCGA -> GGTCGAACGAGAGTTAGTCCCGAT
GAAGAATGTGTCTGTACTCTTGTC -> AAGAATGTGTCTGTACTCTTGTCG
TGAGTGCTCGTTATCTAAATTCGC -> GAGTGCTCGTTATCTAAATTCGCC
GTTCAAGTATCCACCGTGTCAAAG -> TTCAAGTATCCACCGTGTCAAAGG
TCCACGATAATCACATACACGAAG -> CCACGATAATCACATACACGAAGT
GTCGAGACGAATTACTAGATAGGG -> TCGAGACGAATTACTAGATAGGGG
TCGTCCGGCTTACGAAATTTATCG -> CGTCCGGCTTACGAAATTTATCGC
TGGACCCCATCTCCACCCATGACG -> GGACCCCATCTCCACCCATGACGA
AAGTATCCGTGCTCGATCAACGTT -> AGTATCCGTGCTCGATCAACGTTT
AATGTTGATCCGCAACGCTCACCC -> ATGTTGATCCGCAACGCTCACCCT
CATGGGTGTGACGCTTCGCGCGAC -> ATGGGTGTGACGCTTCGCGCGACT
GAATTGGATCAGAACAGCAGCGGA -> AATTGGATCAGAACAGCAGCGGAC
CCTGGACCCGCTACAGTCTCAAAT -> CTGGACCCGCTACAGTCTCAAATC
AGCAGCGGACCGGCATGGGCGATA -> GCAGCGGACCGGCATGGGCGATAC
ATACAATTATTAGTCCCCTTTGGT -> TACAATTATTAGTCCCCTTTGGTA
CCGATATGGGTCCTGTCGCCAGGT -> CGATATGGGTCCTGTCGCCAGGTT
TCCGAATTGCAACATCGTGACCTG -> CCGAATTGCAACATCGTGACCTGA
CCTGAAGGCTCGCATTTCGTCCGG -> CTGAAGGCTCGCATTTCGTCCGGC
ATTATGGTATATGTGCGGGTCATC -> TTATGGTATATGTGCGGGTCATCG
ACAAGCATGGAGACTCTTGGGTCC -> CAAGCATGGAGACTCTTGGGTCCC
TTTAGCTCAGGATGTATGACCATA -> TTAGCTCAGGATGTATGACCATAC
GATGTATGACCATACACGGGAAAC -> ATGTATGACCATACACGGGAAACG
CTCCACCCATGACGATTGTAGACG -> TCCACCCATGACGATTGTAGACGC
GAAACGGGAAAGGGACTTACAATA -> AAACGGGAAAGGGACTTACAATAG
AATAAGAATGTAGTTATATGGGTC -> ATAAGAATGTAGTTATATGGGTCG
ATATGGGTCGCCACGTTGAAGGAG -> TATGGGTCGCCACGTTGAAGGAGG
GATAATCACATACACGAAGTTTCG -> ATAATCACATACACGAAGTTTCGA
AGGAGGGTATGAACCACGACCGCT -> GGAGGGTATGAACCACGACCGCTT
GTGTTTTGCCTTTAGCTCAGGATG -> TGTTTTGCCTTTAGCTCAGGATGT
CCCTTTGGTAAATCAATCCACGAT -> CCTTTGGTAAATCAATCCACGATA
CTGAGTGCTCGTTATCTAAATTCG -> TGAGTGCTCGTTATCTAAATTCGC
GCGACTAGACGCCGGAGGCACGCT -> CGACTAGACGCCGGAGGCACGCTG
ATCAATCCACGATAATCACATACA -> TCAATCCACGATAATCACATACAC
CTAACCCGCAACACAGATACCAAG -> TAACCCGCAACACAGATACCAAGA
CCTCCACCAGCGATTGCGTGTGAC -> CTCCACCAGCGATTGCGTGTGACG
GAACAGCAGCGGACCGGCATGGGC -> AACAGCAGCGGACCGGCATGGGCG
GACGAGTCTGAGAGACTGTGAAAA -> ACGAGTCTGAGAGACTGTGAAAAT
TGCATTGAGATCACACAACATCTC -> GCATTGAGATCACACAACATCTCT
GTTGCTGGTTGCTCACTTGACATG -> TTGCTGGTTGCTCACTTGACATGG
GTCCTGTCGCCAGGTTCACTCATT -> TCCTGTCGCCAGGTTCACTCATTA
GAGAGAAGAATGTGTCTGTACTCT -> AGAGAAGAATGTGTCTGTACTCTT
ATTGTAGACGCATCGAGACAAGCA -> TTGTAGACGCATCGAGACAAGCAT
GCGGACCGGCATGGGCGATACAGC -> CGGACCGGCATGGGCGATACAGCC
GAGTATTACGCGTTAAGTATCTAA -> AGTATTACGCGTTAAGTATCTAAT
ACGTCCACTTTGAAACATGCCAAT -> CGTCCACTTTGAAACATGCCAATA
GTTCGGGTGATTGGTAGCGTAGAG -> TTCGGGTGATTGGTAGCGTAGAGT
GATTGGTAGCGTAGAGTTTTTTTT -> ATTGGTAGCGTAGAGTTTTTTTTC
GTCGCAGCACTAGCTCCTGCGAAC -> TCGCAGCACTAGCTCCTGCGAACC
CACACTCAGTGAGTATTACGCGTT -> ACACTCAGTGAGTATTACGCGTTA
GAGATTGACGTGGCTGTGGGCGGC -> AGATTGACGTGGCTGTGGGCGGCT
GTATGAACCACGACCGCTTGGACT -> TATGAACCACGACCGCTTGGACTG
GGGCGTTTCCATGTCTCTCTATAT -> GGCGTTTCCATGTCTCTCTATATT
TTAGTCCCCTTTGGTAAATCAATC -> TAGTCCCCTTTGGTAAATCAATCC
TATATTTAAATCGCCAGAACTCGA -> ATATTTAAATCGCCAGAACTCGAT
AGTTTCGAGGCGACGTCGTTTACG -> GTTTCGAGGCGACGTCGTTTACGC
GGTTCGGGTGATTGGTAGCGTAGA -> GTTCGGGTGATTGGTAGCGTAGAG
GGTTTGTGAAATACAATTATTAGT -> GTTTGTGAAATACAATTATTAGTC
ATATTGAGGTGTCGGCAGTCCTGG -> TATTGAGGTGTCGGCAGTCCTGGA
AGTGAGTATTACGCGTTAAGTATC -> GTGAGTATTACGCGTTAAGTATCT
GAATTGCAACATCGTGACCTGAGT -> AATTGCAACATCGTGACCTGAGTG
GGCACGCTGGACCCCATCTCCACC -> GCACGCTGGACCCCATCTCCACCC
CCCGCGAAGCTCGAATTTCCCAGT -> CCGCGAAGCTCGAATTTCCCAGTT
TTGAACATGTGAGTTCAACCAAGA -> TGAACATGTGAGTTCAACCAAGAC
TGTGCCTGACAACTGACTTTAAGC -> GTGCCTGACAACTGACTTTAAGCA
GTCGCCACGTTGAAGGAGGTCGCA -> TCGCCACGTTGAAGGAGGTCGCAG
CCTGAGTGCTCGTTATCTAAATTC -> CTGAGTGCTCGTTATCTAAATTCG
CATTTGGCTTGGCCAGTTGCATAG -> ATTTGGCTTGGCCAGTTGCATAGG
CGAGATTGACGTGGCTGTGGGCGG -> GAGATTGACGTGGCTGTGGGCGGC
GGGCTGAATCTCACTTAGCGAACA -> GGCTGAATCTCACTTAGCGAACAA
TCAATTCCCGCTCTTAAACCGCAG -> CAATTCCCGCTCTTAAACCGCAGT
TAGCTGTGCCTGACAACTGACTTT -> AGCTGTGCCTGACAACTGACTTTA
TCGAGACGAATTACTAGATAGGGG -> CGAGACGAATTACTAGATAGGGGG
GAGATCACACAACATCTCTTCTCT -> AGATCACACAACATCTCTTCTCTT
TTGCCTTTAGCTCAGGATGTATGA -> TGCCTTTAGCTCAGGATGTATGAC
GCTAAGACGCCGACTTTGAACATG -> CTAAGACGCCGACTTTGAACATGT
TCTCGTCGAAGCTTGAGACGAGTC -> CTCGTCGAAGCTTGAGACGAGTCT
CGAGACAAGCATGGAGACTCTTGG -> GAGACAAGCATGGAGACTCTTGGG
TGCAACATCGTGACCTGAGTGCTC -> GCAACATCGTGACCTGAGTGCTCG
GTCTCTCTATATTTAAATCGCCAG -> TCTCTCTATATTTAAATCGCCAGA
TTAGCTCAGGATGTATGACCATAC -> TAGCTCAGGATGTATGACCATACA
GCATTTCGTCCGGCTTACGAAATT -> CATTTCGTCCGGCTTACGAAATTT
ATACACGGGAAACGGGAAAGGGAC -> TACACGGGAAACGGGAAAGGGACT
AAAGGGACTTACAATAGTCTCCCA -> AAGGGACTTACAATAGTCTCCCAT
GTGTGACGCTTCGCGCGACTAGAC -> TGTGACGCTTCGCGCGACTAGACG
CGGGAAAGGGACTTACAATAGTCT -> GGGAAAGGGACTTACAATAGTCTC
AATTGGATCAGAACAGCAGCGGAC -> ATTGGATCAGAACAGCAGCGGACC
TTTCCATGTCTCTCTATATTTAAA -> TTCCATGTCTCTCTATATTTAAAT
GTGACGCTTCGCGCGACTAGACGC -> TGACGCTTCGCGCGACTAGACGCC
GCGCATATTGAGGTGTCGGCAGTC -> CGCATATTGAGGTGTCGGCAGTCC
CGTTTCCATGTCTCTCTATATTTA -> GTTTCCATGTCTCTCTATATTTAA
CCCTTATAACGGCTCTCGAAGAAA -> CCTTATAACGGCTCTCGAAGAAAC
CTTCGGCGTGTTGGCGGGACAATG -> TTCGGCGTGTTGGCGGGACAATGT
CACGAAGTTTCGAGGCGACGTCGT -> ACGAAGTTTCGAGGCGACGTCGTT
CCATTTACGTGTGTCCTTCGGCGT -> CATTTACGTGTGTCCTTCGGCGTG
AAGAATGTGTCTGTACTCTTGTCG -> AGAATGTGTCTGTACTCTTGTCGG
CACGACCGCTTGGACTGAACCCTT -> ACGACCGCTTGGACTGAACCCTTA
AAGTCACGCGATAGCGGCTGCTTC -> AGTCACGCGATAGCGGCTGCTTCC
AGTATTACGCGTTAAGTATCTAAT -> GTATTACGCGTTAAGTATCTAATA
TTTATTGAGTCATTAGCTGGGAAG -> TTATTGAGTCATTAGCTGGGAAGA
TCGCCCGCCTGTCTAGCATGGACC -> CGCCCGCCTGTCTAGCATGGACCA
CGATCTTGGAAAAAATGCACAATC -> GATCTTGGAAAAAATGCACAATCG
AATGCACAATCGACCCACTGTGGC -> ATGCACAATCGACCCACTGTGGCT
CTCTTGTCGGGTACTTATGGATAT -> TCTTGTCGGGTACTTATGGATATG
TCCGTATGGGCCGATACTGACCCC -> CCGTATGGGCCGATACTGACCCCT
AAAATGACACGTGTGCCCAATGGG -> AAATGACACGTGTGCCCAATGGGC
GGGTCCCCGTGCGATGGGGCTTTA -> GGTCCCCGTGCGATGGGGCTTTAG
CCTGGACGTCGGACTTTTATTGCG -> CTGGACGTCGGACTTTTATTGCGG
GCGCGCATATTGAGGTGTCGGCAG -> CGCGCATATTGAGGTGTCGGCAGT
ATGTATGACCATACACGGGAAACG -> TGTATGACCATACACGGGAAACGG
TAGGAGGGTATGAACCACGACCGC -> AGGAGGGTATGAACCACGACCGCT
CTTTAGCTCAGGATGTATGACCAT -> TTTAGCTCAGGATGTATGACCATA
GACTCTTGGGTCCCCGTGCGATGG -> ACTCTTGGGTCCCCGTGCGATGGG
TCCGTCTCTGTTCTCCAGAAGATC -> CCGTCTCTGTTCTCCAGAAGATCT
TACAATTATTAGTCCCCTTTGGTA -> ACAATTATTAGTCCCCTTTGGTAA
TTTGGTAAATCAATCCACGATAAT -> TTGGTAAATCAATCCACGATAATC
CGATATGGGTCCTGTCGCCAGGTT -> GATATGGGTCCTGTCGCCAGGTTC
AGCGATTGCGTGTGACGTTTCCCA -> GCGATTGCGTGTGACGTTTCCCAC
GTACTTATGGATATGGACGAGATT -> TACTTATGGATATGGACGAGATTG
GTGAGTTCAACCAAGACATGGTAC -> TGAGTTCAACCAAGACATGGTACT
GCCCTCTATCGGGGATGACTCCGG -> CCCTCTATCGGGGATGACTCCGGT
CTTAGATCAATTCCCGCTCTTAAA -> TTAGATCAATTCCCGCTCTTAAAC
GTCTCTGTTCTCCAGAAGATCTCG -> TCTCTGTTCTCCAGAAGATCTCGT
GTCTGAGAGACTGTGAAAATGACA -> TCTGAGAGACTGTGAAAATGACAC
AACTGCTCATGATGAAATACCATA -> ACTGCTCATGATGAAATACCATAT
CCCCATGAGAATCCGAATTGCAAC -> CCCATGAGAATCCGAATTGCAACA
GAAGAAACAGGAGGACGGTTATAA -> AAGAAACAGGAGGACGGTTATAAG
AAATCGGTTGCTGGTTGCTCACTT -> AATCGGTTGCTGGTTGCTCACTTG
TAGGTCCACACGTCGAGACGAATT -> AGGTCCACACGTCGAGACGAATTA
TCCACACGTCGAGACGAATTACTA -> CCACACGTCGAGACGAATTACTAG
GTCCGGCTTACGAAATTTATCGCC -> TCCGGCTTACGAAATTTATCGCCG
CATCCCACCGACACACTCAGTGAG -> ATCCCACCGACACACTCAGTGAGT
GAGACGAGTCTGAGAGACTGTGAA -> AGACGAGTCTGAGAGACTGTGAAA
TCGGACTTTTATTGCGGCGGTCGA -> CGGACTTTTATTGCGGCGGTCGAA
TCACATAAGTCACGCGATAGCGGC -> CACATAAGTCACGCGATAGCGGCT
ATCCGTGCTCGATCAACGTTTATT -> TCCGTGCTCGATCAACGTTTATTG
TCCAGAAGATCTCGTGGTTCGGGT -> CCAGAAGATCTCGTGGTTCGGGTG
TTTATTGCGGCGGTCGAACGAGAG -> TTATTGCGGCGGTCGAACGAGAGT
GTCGTTTACGCCATAGCTGTGCCT -> TCGTTTACGCCATAGCTGTGCCTG
CATGTGAGTTCAACCAAGACATGG -> ATGTGAGTTCAACCAAGACATGGT
CCGTGTCAAAGGTTATTACATAAA -> CGTGTCAAAGGTTATTACATAAAA
ATTTATCGCCGCATTCACATAAGT -> TTTATCGCCGCATTCACATAAGTC
CACCCATGACGATTGTAGACGCAT -> ACCCATGACGATTGTAGACGCATC
TGGGCGTTTCCATGTCTCTCTATA -> GGGCGTTTCCATGTCTCTCTATAT
CAAGAAAAATGCTTCGCCTCCGGC -> AAGAAAAATGCTTCGCCTCCGGCT
CGAAGCTCGAATTTCCCAGTTTGG -> GAAGCTCGAATTTCCCAGTTTGGT
CCACCCATGACGATTGTAGACGCA -> CACCCATGACGATTGTAGACGCAT
GGCAGTCCTGGACGTCGGACTTTT -> GCAGTCCTGGACGTCGGACTTTTA
ATTTCCCAGTTTGGTGTTTTGCCT -> TTTCCCAGTTTGGTGTTTTGCCTT
AAGTATCTAATACGGTCCACAAAT -> AGTATCTAATACGGTCCACAAATC
TCACCCTTAGATCAATTCCCGCTC -> CACCCTTAGATCAATTCCCGCTCT
ATTAGCTGGGAAGAAGAAGAGGTC -> TTAGCTGGGAAGAAGAAGAGGTCC
TTACTAGATAGGGGGCTCCTCCAC -> TACTAGATAGGGGGCTCCTCCACC
CGGATTATGGTATATGTGCGGGTC -> GGATTATGGTATATGTGCGGGTCA
CTAGGTCCACACGTCGAGACGAAT -> TAGGTCCACACGTCGAGACGAATT
GAGAGTTAGTCCCGATATGGGTCC -> AGAGTTAGTCCCGATATGGGTCCT
AAATACACATTCCTATCTATTTCA -> AATACACATTCCTATCTATTTCAC
TGAGTCATTAGCTGGGAAGAAGAA -> GAGTCATTAGCTGGGAAGAAGAAG
ACGTTAACGCTGTAAAATTCCGTA -> CGTTAACGCTGTAAAATTCCGTAT
ATATGTGCGGGTCATCGCACCATA -> TATGTGCGGGTCATCGCACCATAG
CTCAAATCTGACGCTAGGTCCACA -> TCAAATCTGACGCTAGGTCCACAC
GTACTCTTGTCGGGTACTTATGGA -> TACTCTTGTCGGGTACTTATGGAT
AGCTGTGCCTGACAACTGACTTTA -> GCTGTGCCTGACAACTGACTTTAA
TGTCTGTACTCTTGTCGGGTACTT -> GTCTGTACTCTTGTCGGGTACTTA
AGCTCGAATTTCCCAGTTTGGTGT -> GCTCGAATTTCCCAGTTTGGTGTT
ACGACCGCTTGGACTGAACCCTTA -> CGACCGCTTGGACTGAACCCTTAT
TGGATATGGACGAGATTGACGTGG -> GGATATGGACGAGATTGACGTGGC
GCGTGTTGGCGGGACAATGTTGAT -> CGTGTTGGCGGGACAATGTTGATC
TCAAATCTGACGCTAGGTCCACAC -> CAAATCTGACGCTAGGTCCACACG
GTCCACACGTCGAGACGAATTACT -> TCCACACGTCGAGACGAATTACTA
CCAGGTTCACTCATTAATAAGAAT -> CAGGTTCACTCATTAATAAGAATG
GCCGGAGGCACGCTGGACCCCATC -> CCGGAGGCACGCTGGACCCCATCT
GGACTTACAATAGTCTCCCATTTA -> GACTTACAATAGTCTCCCATTTAC
GACCAACTGCTCATGATGAAATAC -> ACCAACTGCTCATGATGAAATACC
GACTAAGTATCCGTGCTCGATCAA -> ACTAAGTATCCGTGCTCGATCAAC
TAACGGCTCTCGAAGAAACAGGAG -> AACGGCTCTCGAAGAAACAGGAGG
TCAACCAAGACATGGTACTTCCGG -> CAACCAAGACATGGTACTTCCGGT
TCGCGCGACTAGACGCCGGAGGCA -> CGCGCGACTAGACGCCGGAGGCAC
TCCCACCGACACACTCAGTGAGTA -> CCCACCGACACACTCAGTGAGTAT
TGGTAAATCAATCCACGATAATCA -> GGTAAATCAATCCACGATAATCAC
TTAAGCATCCCACCGACACACTCA -> TAAGCATCCCACCGACACACTCAG
TCCTGAAGGCTCGCATTTCGTCCG -> CCTGAAGGCTCGCATTTCGTCCGG
AACATCTCTTCTCTTCTTGGGTGG -> ACATCTCTTCTCTTCTTGGGTGGA
GACAAGAAAAATGCTTCGCCTCCG -> ACAAGAAAAATGCTTCGCCTCCGG
AGATCAATTCCCGCTCTTAAACCG -> GATCAATTCCCGCTCTTAAACCGC
AACCGCAGTTTATTGTATTCAGTT -> ACCGCAGTTTATTGTATTCAGTTG
GTGTCAAAGGTTATTACATAAAAC -> TGTCAAAGGTTATTACATAAAACG
GCCCAATGGGCGTTTCCATGTCTC -> CCCAATGGGCGTTTCCATGTCTCT
CACGTCGAGACGAATTACTAGATA -> ACGTCGAGACGAATTACTAGATAG
CGATGGGGCTTTAGTTCAAGTATC -> GATGGGGCTTTAGTTCAAGTATCC
TCGCATTTCGTCCGGCTTACGAAA -> CGCATTTCGTCCGGCTTACGAAAT
GACTCCGGTTTGTGAAATACAATT -> ACTCCGGTTTGTGAAATACAATTA
GAGGTCCTGAAGGCTCGCATTTCG -> AGGTCCTGAAGGCTCGCATTTCGT
GCTCATGATGAAATACCATATGTG -> CTCATGATGAAATACCATATGTGC
ACGAGAGTTAGTCCCGATATGGGT -> CGAGAGTTAGTCCCGATATGGGTC
TCTCCCATTTACGTGTGTCCTTCG -> CTCCCATTTACGTGTGTCCTTCGG
TGATGAAATACCATATGTGCTGCG -> GATGAAATACCATATGTGCTGCGC
CTGAGAGACTGTGAAAATGACACG -> TGAGAGACTGTGAAAATGACACGT
GTCATTAGCTGGGAAGAAGAAGAG -> TCATTAGCTGGGAAGAAGAAGAGG
AGCTGGGAAGAAGAAGAGGTCCTG -> GCTGGGAAGAAGAAGAGGTCCTGA
CATTCACATAAGTCACGCGATAGC -> ATTCACATAAGTCACGCGATAGCG
CAGCACTAGCTCCTGCGAACCACA -> AGCACTAGCTCCTGCGAACCACAG
TTGACGTGGCTGTGGGCGGCTGCA -> TGACGTGGCTGTGGGCGGCTGCAT
ACGTTTCCCACGGGCTGAATCTCA -> CGTTTCCCACGGGCTGAATCTCAC
TGAAGGAGGTCGCAGCACTAGCTC -> GAAGGAGGTCGCAGCACTAGCTCC
CTTGGGTCCCCGTGCGATGGGGCT -> TTGGGTCCCCGTGCGATGGGGCTT
CGGGAAACGGGAAAGGGACTTACA -> GGGAAACGGGAAAGGGACTTACAA
TAGTTATATGGGTCGCCACGTTGA -> AGTTATATGGGTCGCCACGTTGAA
GCAGTTTATTGTATTCAGTTGTCG -> CAGTTTATTGTATTCAGTTGTCGG
TTTCCCGCGAAGCTCGAATTTCCC -> TTCCCGCGAAGCTCGAATTTCCCA
GCATCCCACCGACACACTCAGTGA -> CATCCCACCGACACACTCAGTGAG
CCCTCTATCGGGGATGACTCCGGT -> CCTCTATCGGGGATGACTCCGGTT
AGCTCCTGCGAACCACAGGTCGGA -> GCTCCTGCGAACCACAGGTCGGAT
GACAACTGACTTTAAGCATCCCAC -> ACAACTGACTTTAAGCATCCCACC
TACGTCGGGCGGGAAATCCGTCTC -> ACGTCGGGCGGGAAATCCGTCTCT
GGCGGCTGCATAGCAGAAGGTCCT -> GCGGCTGCATAGCAGAAGGTCCTC
TTTGGTGTTTTGCCTTTAGCTCAG -> TTGGTGTTTTGCCTTTAGCTCAGG
TCCACCAGCGATTGCGTGTGACGT -> CCACCAGCGATTGCGTGTGACGTT
TTCGCCCGCCTGTCTAGCATGGAC -> TCGCCCGCCTGTCTAGCATGGACC
TTCCATTCGAGAACTAACGGTGTG -> TCCATTCGAGAACTAACGGTGTGG
CGACGTCGTTTACGCCATAGCTGT -> GACGTCGTTTACGCCATAGCTGTG
CATGATGAAATACCATATGTGCTG -> ATGATGAAATACCATATGTGCTGC
GGGTCCTGTCGCCAGGTTCACTCA -> GGTCCTGTCGCCAGGTTCACTCAT
ACCGCTTGGACTGAACCCTTATAA -> CCGCTTGGACTGAACCCTTATAAC
AGTCGAGAACGTCCACTTTGAAAC -> GTCGAGAACGTCCACTTTGAAACA
ATATTTAAATCGCCAGAACTCGAT -> TATTTAAATCGCCAGAACTCGATT
TAGTCTCCCATTTACGTGTGTCCT -> AGTCTCCCATTTACGTGTGTCCTT
GGTATATGTGCGGGTCATCGCACC -> GTATATGTGCGGGTCATCGCACCA
GAACGAGAGTTAGTCCCGATATGG -> AACGAGAGTTAGTCCCGATATGGG
AAATGCACAATCGACCCACTGTGG -> AATGCACAATCGACCCACTGTGGC
TCCCGATATGGGTCCTGTCGCCAG -> CCCGATATGGGTCCTGTCGCCAGG
GGGAAAGGGACTTACAATAGTCTC -> GGAAAGGGACTTACAATAGTCTCC
CTGTCTAGCATGGACCAACTGCTC -> TGTCTAGCATGGACCAACTGCTCA
ACTACCCGCTAACCCGCAACACAG -> CTACCCGCTAACCCGCAACACAGA
TGGCTCTAGCACCTCAGTCGAGAA -> GGCTCTAGCACCTCAGTCGAGAAC
CTAATACGGTCCACAAATCGGTTG -> TAATACGGTCCACAAATCGGTTGC
CCCACGGGCTGAATCTCACTTAGC -> CCACGGGCTGAATCTCACTTAGCG
TATGGGTCGCCACGTTGAAGGAGG -> ATGGGTCGCCACGTTGAAGGAGGT
GACGTCGGACTTTTATTGCGGCGG -> ACGTCGGACTTTTATTGCGGCGGT
TCAGAACAGCAGCGGACCGGCATG -> CAGAACAGCAGCGGACCGGCATGG
CGGCTGCATAGCAGAAGGTCCTCG -> GGCTGCATAGCAGAAGGTCCTCGG
GAGACGAATTACTAGATAGGGGGC -> AGACGAATTACTAGATAGGGGGCT
CGAAGCTTGAGACGAGTCTGAGAG -> GAAGCTTGAGACGAGTCTGAGAGA
TCCTGTCGCCAGGTTCACTCATTA -> CCTGTCGCCAGGTTCACTCATTAA
CGGACCGGCATGGGCGATACAGCC -> GGACCGGCATGGGCGATACAGCCC
AAAGCTAAGGCTTTTCGATACGTC -> AAGCTAAGGCTTTTCGATACGTCG
GTCGGCAGTCCTGGACGTCGGACT -> TCGGCAGTCCTGGACGTCGGACTT
CACATAAGTCACGCGATAGCGGCT -> ACATAAGTCACGCGATAGCGGCTG
ATCGGTTGCTGGTTGCTCACTTGA -> TCGGTTGCTGGTTGCTCACTTGAC
CGCTCACCCTTAGATCAATTCCCG -> GCTCACCCTTAGATCAATTCCCGC
TGGACCCGCTACAGTCTCAAATCT -> GGACCCGCTACAGTCTCAAATCTG
ATGGGCGATACAGCCCGACATTTG -> TGGGCGATACAGCCCGACATTTGG
GTTAAGTATCTAATACGGTCCACA -> TTAAGTATCTAATACGGTCCACAA
AAATACAATTATTAGTCCCCTTTG -> AATACAATTATTAGTCCCCTTTGG
TCCCACGGGCTGAATCTCACTTAG -> CCCACGGGCTGAATCTCACTTAGC
ATGAACCACGACCGCTTGGACTGA -> TGAACCACGACCGCTTGGACTGAA
GGAACTTTAGACAAGAAAAATGCT -> GAACTTTAGACAAGAAAAATGCTT
GAGAAGAATGTGTCTGTACTCTTG -> AGAAGAATGTGTCTGTACTCTTGT
GTGACCTGAGTGCTCGTTATCTAA -> TGACCTGAGTGCTCGTTATCTAAA
GAGAATCCGAATTGCAACATCGTG -> AGAATCCGAATTGCAACATCGTGA
CGAGTACGTTAACGCTGTAAAATT -> GAGTACGTTAACGCTGTAAAATTC
TAGACAAGAAAAATGCTTCGCCTC -> AGACAAGAAAAATGCTTCGCCTCC
AGTATCTAATACGGTCCACAAATC -> GTATCTAATACGGTCCACAAATCG
CAGAAGATCTCGTGGTTCGGGTGA -> AGAAGATCTCGTGGTTCGGGTGAT
ATTTAAATCGCCAGAACTCGATTT -> TTTAAATCGCCAGAACTCGATTTC
ATGTTGATCCGCAACGCTCACCCT -> TGTTGATCCGCAACGCTCACCCTT
CGAATTGCAACATCGTGACCTGAG -> GAATTGCAACATCGTGACCTGAGT
TTCGGGTGATTGGTAGCGTAGAGT -> TCGGGTGATTGGTAGCGTAGAGTT
TGGGTCCCCGTGCGATGGGGCTTT -> GGGTCCCCGTGCGATGGGGCTTTA
ATAGCTGTGCCTGACAACTGACTT -> TAGCTGTGCCTGACAACTGACTTT
CTGTGGCTCTAGCACCTCAGTCGA -> TGTGGCTCTAGCACCTCAGTCGAG
TGACGATTGTAGACGCATCGAGAC -> GACGATTGTAGACGCATCGAGACA
GACACACTCAGTGAGTATTACGCG -> ACACACTCAGTGAGTATTACGCGT
GATCTCCGTTGTTCTCGTCGAAGC -> ATCTCCGTTGTTCTCGTCGAAGCT
CATTAGCTGGGAAGAAGAAGAGGT -> ATTAGCTGGGAAGAAGAAGAGGTC
TACCAAGAATTGGATCAGAACAGC -> ACCAAGAATTGGATCAGAACAGCA
CGGTTTGTGAAATACAATTATTAG -> GGTTTGTGAAATACAATTATTAGT
CACACAACATCTCTTCTCTTCTTG -> ACACAACATCTCTTCTCTTCTTGG
CATAGGAGGGTATGAACCACGACC -> ATAGGAGGGTATGAACCACGACCG
ATCTGACGCTAGGTCCACACGTCG -> TCTGACGCTAGGTCCACACGTCGA
AATGTGTCTGTACTCTTGTCGGGT -> ATGTGTCTGTACTCTTGTCGGGTA
TGTTGATCCGCAACGCTCACCCTT -> GTTGATCCGCAACGCTCACCCTTA
TCTGTTCTCCAGAAGATCTCGTGG -> CTGTTCTCCAGAAGATCTCGTGGT
GCATGGACCAACTGCTCATGATGA -> CATGGACCAACTGCTCATGATGAA
CCGTATGGGCCGATACTGACCCCT -> CGTATGGGCCGATACTGACCCCTG
ATTAGTCCCCTTTGGTAAATCAAT -> TTAGTCCCCTTTGGTAAATCAATC
GCCTGTCTAGCATGGACCAACTGC -> CCTGTCTAGCATGGACCAACTGCT
CCGTCTCTGTTCTCCAGAAGATCT -> CGTCTCTGTTCTCCAGAAGATCTC
CGCCTGTCTAGCATGGACCAACTG -> GCCTGTCTAGCATGGACCAACTGC
CACAACATCTCTTCTCTTCTTGGG -> ACAACATCTCTTCTCTTCTTGGGT
ACGTCGGACTTTTATTGCGGCGGT -> CGTCGGACTTTTATTGCGGCGGTC
TGGCGAAAAGCTAAGGCTTTTCGA -> GGCGAAAAGCTAAGGCTTTTCGAT
CTCTCGAAGAAACAGGAGGACGGT -> TCTCGAAGAAACAGGAGGACGGTT
AATTGCAACATCGTGACCTGAGTG -> ATTGCAACATCGTGACCTGAGTGC
CTTGGACTGAACCCTTATAACGGC -> TTGGACTGAACCCTTATAACGGCT
GTTATCTAAATTCGCCCGCCTGTC -> TTATCTAAATTCGCCCGCCTGTCT
GCGTAGAGTTTTTTTTCCCGCGAA -> CGTAGAGTTTTTTTTCCCGCGAAG
ACAGGAGGACGGTTATAAGGTGCA -> CAGGAGGACGGTTATAAGGTGCAT
CTCCGGTTTGTGAAATACAATTAT -> TCCGGTTTGTGAAATACAATTATT
GCATGGGCGATACAGCCCGACATT -> CATGGGCGATACAGCCCGACATTT
CTGGACGTCGGACTTTTATTGCGG -> TGGACGTCGGACTTTTATTGCGGC
TTTCCCACGGGCTGAATCTCACTT -> TTCCCACGGGCTGAATCTCACTTA
ATGGACTAAGTATCCGTGCTCGAT -> TGGACTAAGTATCCGTGCTCGATC
GGGGCTCCTCCACCAGCGATTGCG -> GGGCTCCTCCACCAGCGATTGCGT
TCTAGCACCTCAGTCGAGAACGTC -> CTAGCACCTCAGTCGAGAACGTCC
TCTAGCATGGACCAACTGCTCATG -> CTAGCATGGACCAACTGCTCATGA
GGCGAACGTCAAAATACACATTCC -> GCGAACGTCAAAATACACATTCCT
ACGGCTCTCGAAGAAACAGGAGGA -> CGGCTCTCGAAGAAACAGGAGGAC
GTTATAAGGTGCATTGAGATCACA -> TTATAAGGTGCATTGAGATCACAC
AGGTCGGATTATGGTATATGTGCG -> GGTCGGATTATGGTATATGTGCGG
TATCTAAATTCGCCCGCCTGTCTA -> ATCTAAATTCGCCCGCCTGTCTAG
GTAGCGTAGAGTTTTTTTTCCCGC -> TAGCGTAGAGTTTTTTTTCCCGCG
CTCGGAACTTTAGACAAGAAAAAT -> TCGGAACTTTAGACAAGAAAAATG
GCTTTTCGATACGTCGGGCGGGAA -> CTTTTCGATACGTCGGGCGGGAAA
TGAACATGTGAGTTCAACCAAGAC -> GAACATGTGAGTTCAACCAAGACA
AACGTCAAAATACACATTCCTATC -> ACGTCAAAATACACATTCCTATCT
GCTCCTCCACCAGCGATTGCGTGT -> CTCCTCCACCAGCGATTGCGTGTG
GACGTGGCTGTGGGCGGCTGCATA -> ACGTGGCTGTGGGCGGCTGCATAG
CTGTACTCTTGTCGGGTACTTATG -> TGTACTCTTGTCGGGTACTTATGG
GAGAGACTGTGAAAATGACACGTG -> AGAGACTGTGAAAATGACACGTGT
ATGACACGTGTGCCCAATGGGCGT -> TGACACGTGTGCCCAATGGGCGTT
ACAATTATTAGTCCCCTTTGGTAA -> CAATTATTAGTCCCCTTTGGTAAA
TTGCGGCGGTCGAACGAGAGTTAG -> TGCGGCGGTCGAACGAGAGTTAGT
ACGCTTCGCGCGACTAGACGCCGG -> CGCTTCGCGCGACTAGACGCCGGA
AACATGCCAATAGGCACTATACCT -> ACATGCCAATAGGCACTATACCTA
GACATTTGGCTTGGCCAGTTGCAT -> ACATTTGGCTTGGCCAGTTGCATA
CGTTAACGCTGTAAAATTCCGTAT -> GTTAACGCTGTAAAATTCCGTATG
TTATATGGGTCGCCACGTTGAAGG -> TATATGGGTCGCCACGTTGAAGGA
GTAGACGCATCGAGACAAGCATGG -> TAGACGCATCGAGACAAGCATGGA
CATGACGATTGTAGACGCATCGAG -> ATGACGATTGTAGACGCATCGAGA
CTGCTCATGATGAAATACCATATG -> TGCTCATGATGAAATACCATATGT
AACCACAGGTCGGATTATGGTATA -> ACCACAGGTCGGATTATGGTATAT
CGTGTCAAAGGTTATTACATAAAA -> GTGTCAAAGGTTATTACATAAAAC
AACTAACGGTGTGGCGAACGTCAA -> ACTAACGGTGTGGCGAACGTCAAA
TCACACAACATCTCTTCTCTTCTT -> CACACAACATCTCTTCTCTTCTTG
TCCGTGCTCGATCAACGTTTATTG -> CCGTGCTCGATCAACGTTTATTGA
TCTATTTCACGAGTACGTTAACGC -> CTATTTCACGAGTACGTTAACGCT
ACATACACGAAGTTTCGAGGCGAC -> CATACACGAAGTTTCGAGGCGACG
ACCCGCAACACAGATACCAAGAAT -> CCCGCAACACAGATACCAAGAATT
AGTCTGAGAGACTGTGAAAATGAC -> GTCTGAGAGACTGTGAAAATGACA
AATACGGTCCACAAATCGGTTGCT -> ATACGGTCCACAAATCGGTTGCTG
AGTTTGGTGTTTTGCCTTTAGCTC -> GTTTGGTGTTTTGCCTTTAGCTCA
AATACACATTCCTATCTATTTCAC -> ATACACATTCCTATCTATTTCACG
GACCCCATCTCCACCCATGACGAT -> ACCCCATCTCCACCCATGACGATT
CATGGACTAAGTATCCGTGCTCGA -> ATGGACTAAGTATCCGTGCTCGAT
CTGCGCGCATATTGAGGTGTCGGC -> TGCGCGCATATTGAGGTGTCGGCA
GAGTTTTTTTTCCCGCGAAGCTCG -> AGTTTTTTTTCCCGCGAAGCTCGA
CTCAGTGAGTATTACGCGTTAAGT -> TCAGTGAGTATTACGCGTTAAGTA
CCCCTGGACCCGCTACAGTCTCAA -> CCCTGGACCCGCTACAGTCTCAAA
GATTGCGTGTGACGTTTCCCACGG -> ATTGCGTGTGACGTTTCCCACGGG
ATTGTATTCAGTTGTCGGCCTGCA -> TTGTATTCAGTTGTCGGCCTGCAT
ATGTGAGTTCAACCAAGACATGGT -> TGTGAGTTCAACCAAGACATGGTA
CGGCTTACGAAATTTATCGCCGCA -> GGCTTACGAAATTTATCGCCGCAT
CAGCAGCGGACCGGCATGGGCGAT -> AGCAGCGGACCGGCATGGGCGATA
TGAACCCTTATAACGGCTCTCGAA -> GAACCCTTATAACGGCTCTCGAAG
GGGGGCTCCTCCACCAGCGATTGC -> GGGGCTCCTCCACCAGCGATTGCG
GTCATCGCACCATAGCACTACCCG -> TCATCGCACCATAGCACTACCCGC
CGAATTACTAGATAGGGGGCTCCT -> GAATTACTAGATAGGGGGCTCCTC
TCCACCGTGTCAAAGGTTATTACA -> CCACCGTGTCAAAGGTTATTACAT
GCTGGACCCCATCTCCACCCATGA -> CTGGACCCCATCTCCACCCATGAC
TCCCGCGAAGCTCGAATTTCCCAG -> CCCGCGAAGCTCGAATTTCCCAGT
TATGGGTCCTGTCGCCAGGTTCAC -> ATGGGTCCTGTCGCCAGGTTCACT
CGTGTGTCCTTCGGCGTGTTGGCG -> GTGTGTCCTTCGGCGTGTTGGCGG
GCGAAGCTCGAATTTCCCAGTTTG -> CGAAGCTCGAATTTCCCAGTTTGG
GCTGCGCGCATATTGAGGTGTCGG -> CTGCGCGCATATTGAGGTGTCGGC
ATACGTCGGGCGGGAAATCCGTCT -> TACGTCGGGCGGGAAATCCGTCTC
ACACGTGTGCCCAATGGGCGTTTC -> CACGTGTGCCCAATGGGCGTTTCC
GTGGGCGGCTGCATAGCAGAAGGT -> TGGGCGGCTGCATAGCAGAAGGTC
TGTCGGCCTGCATGGGTGTGACGC -> GTCGGCCTGCATGGGTGTGACGCT
TAGCGTAGAGTTTTTTTTCCCGCG -> AGCGTAGAGTTTTTTTTCCCGCGA
ACTGACTTTAAGCATCCCACCGAC -> CTGACTTTAAGCATCCCACCGACA
GACTTTTATTGCGGCGGTCGAACG -> ACTTTTATTGCGGCGGTCGAACGA
AAAATTCCGTATGGGCCGATACTG -> AAATTCCGTATGGGCCGATACTGA
GCTTTAGTTCAAGTATCCACCGTG -> CTTTAGTTCAAGTATCCACCGTGT
GGTCCCCGTGCGATGGGGCTTTAG -> GTCCCCGTGCGATGGGGCTTTAGT
GGGCGGCTGCATAGCAGAAGGTCC -> GGCGGCTGCATAGCAGAAGGTCCT
GGCATGGGCGATACAGCCCGACAT -> GCATGGGCGATACAGCCCGACATT
GTATATGTGCGGGTCATCGCACCA -> TATATGTGCGGGTCATCGCACCAT
TCCTTCGGCGTGTTGGCGGGACAA -> CCTTCGGCGTGTTGGCGGGACAAT
GGCTGCTTCCATAGGCTAAGACGC -> GCTGCTTCCATAGGCTAAGACGCC
AAGACATGGTACTTCCGGTATTTT -> AGACATGGTACTTCCGGTATTTTT
AACGCTGTAAAATTCCGTATGGGC -> ACGCTGTAAAATTCCGTATGGGCC
TTGCTCACTTGACATGGACTAAGT -> TGCTCACTTGACATGGACTAAGTA
CACCGTGTCAAAGGTTATTACATA -> ACCGTGTCAAAGGTTATTACATAA
ACATAAGTCACGCGATAGCGGCTG -> CATAAGTCACGCGATAGCGGCTGC
ACACGTCGAGACGAATTACTAGAT -> CACGTCGAGACGAATTACTAGATA
TCCGGTATTTTTCGAGAGAAGAAT -> CCGGTATTTTTCGAGAGAAGAATG
TTGCGTGTGACGTTTCCCACGGGC -> TGCGTGTGACGTTTCCCACGGGCT
TGTTCTCCAGAAGATCTCGTGGTT -> GTTCTCCAGAAGATCTCGTGGTTC
TCAGTCGAGAACGTCCACTTTGAA -> CAGTCGAGAACGTCCACTTTGAAA
ATCTCCACCCATGACGATTGTAGA -> TCTCCACCCATGACGATTGTAGAC
GGCTGCATAGCAGAAGGTCCTCGG -> GCTGCATAGCAGAAGGTCCTCGGA
ATCGCACCATAGCACTACCCGCTA -> TCGCACCATAGCACTACCCGCTAA
GGAGGCACGCTGGACCCCATCTCC -> GAGGCACGCTGGACCCCATCTCCA
CCATAGGCTAAGACGCCGACTTTG -> CATAGGCTAAGACGCCGACTTTGA
TGTTGGCGGGACAATGTTGATCCG -> GTTGGCGGGACAATGTTGATCCGC
ATACCATATGTGCTGCGCGCATAT -> TACCATATGTGCTGCGCGCATATT
TACACGAAGTTTCGAGGCGACGTC -> ACACGAAGTTTCGAGGCGACGTCG
GGAGGACGGTTATAAGGTGCATTG -> GAGGACGGTTATAAGGTGCATTGA
CAGAAGGTCCTCGGAACTTTAGAC -> AGAAGGTCCTCGGAACTTTAGACA
GACGGTTATAAGGTGCATTGAGAT -> ACGGTTATAAGGTGCATTGAGATC
CGCGTTAAGTATCTAATACGGTCC -> GCGTTAAGTATCTAATACGGTCCA
CACGGGCTGAATCTCACTTAGCGA -> ACGGGCTGAATCTCACTTAGCGAA
GACGCTTCGCGCGACTAGACGCCG -> ACGCTTCGCGCGACTAGACGCCGG
CATGGGCGATACAGCCCGACATTT -> ATGGGCGATACAGCCCGACATTTG
TGGATCAGAACAGCAGCGGACCGG -> GGATCAGAACAGCAGCGGACCGGC
CGTGCGATGGGGCTTTAGTTCAAG -> GTGCGATGGGGCTTTAGTTCAAGT
CTCACTTAGCGAACAACCCCATGA -> TCACTTAGCGAACAACCCCATGAG
CACTACCCGCTAACCCGCAACACA -> ACTACCCGCTAACCCGCAACACAG
TCTCCAGAAGATCTCGTGGTTCGG -> CTCCAGAAGATCTCGTGGTTCGGG
GCGTTTCCATGTCTCTCTATATTT -> CGTTTCCATGTCTCTCTATATTTA
TGGGAAGAAGAAGAGGTCCTGAAG -> GGGAAGAAGAAGAGGTCCTGAAGG
TGACTTTAAGCATCCCACCGACAC -> GACTTTAAGCATCCCACCGACACA
TTGTGAAATACAATTATTAGTCCC -> TGTGAAATACAATTATTAGTCCCC
CGTCGAAGCTTGAGACGAGTCTGA -> GTCGAAGCTTGAGACGAGTCTGAG
TATCTAATACGGTCCACAAATCGG -> ATCTAATACGGTCCACAAATCGGT
GATTGTAGACGCATCGAGACAAGC -> ATTGTAGACGCATCGAGACAAGCA
CCTGACAACTGACTTTAAGCATCC -> CTGACAACTGACTTTAAGCATCCC
GGTCGGATTATGGTATATGTGCGG -> GTCGGATTATGGTATATGTGCGGG
CTTATGGATATGGACGAGATTGAC -> TTATGGATATGGACGAGATTGACG
TAAGGCTTTTCGATACGTCGGGCG -> AAGGCTTTTCGATACGTCGGGCGG
CTGACGCTAGGTCCACACGTCGAG -> TGACGCTAGGTCCACACGTCGAGA
TTCCTATCTATTTCACGAGTACGT -> TCCTATCTATTTCACGAGTACGTT
ACTTACAATAGTCTCCCATTTACG -> CTTACAATAGTCTCCCATTTACGT
AGGAGGTCGCAGCACTAGCTCCTG -> GGAGGTCGCAGCACTAGCTCCTGC
CGACCGCTTGGACTGAACCCTTAT -> GACCGCTTGGACTGAACCCTTATA
AGACTGTGAAAATGACACGTGTGC -> GACTGTGAAAATGACACGTGTGCC
ATGAGAATCCGAATTGCAACATCG -> TGAGAATCCGAATTGCAACATCGT
GACAAGCATGGAGACTCTTGGGTC -> ACAAGCATGGAGACTCTTGGGTCC
AGTTCAACCAAGACATGGTACTTC -> GTTCAACCAAGACATGGTACTTCC
TATATGGGTCGCCACGTTGAAGGA -> ATATGGGTCGCCACGTTGAAGGAG
CACTCAGTGAGTATTACGCGTTAA -> ACTCAGTGAGTATTACGCGTTAAG
CCATGTCTCTCTATATTTAAATCG -> CATGTCTCTCTATATTTAAATCGC
AGTTATATGGGTCGCCACGTTGAA -> GTTATATGGGTCGCCACGTTGAAG
AATTACTAGATAGGGGGCTCCTCC -> ATTACTAGATAGGGGGCTCCTCCA
ACGATCTTGGAAAAAATGCACAAT -> CGATCTTGGAAAAAATGCACAATC
CTAAATTCGCCCGCCTGTCTAGCA -> TAAATTCGCCCGCCTGTCTAGCAT
GAGGACGGTTATAAGGTGCATTGA -> AGGACGGTTATAAGGTGCATTGAG
TCTATATTTAAATCGCCAGAACTC -> CTATATTTAAATCGCCAGAACTCG
GGATGACTCCGGTTTGTGAAATAC -> GATGACTCCGGTTTGTGAAATACA
TGGACCAACTGCTCATGATGAAAT -> GGACCAACTGCTCATGATGAAATA
CAACTGCTCATGATGAAATACCAT -> AACTGCTCATGATGAAATACCATA
TAGTTCAAGTATCCACCGTGTCAA -> AGTTCAAGTATCCACCGTGTCAAA
TGTAGACGCATCGAGACAAGCATG -> GTAGACGCATCGAGACAAGCATGG
TGTGAAATACAATTATTAGTCCCC -> GTGAAATACAATTATTAGTCCCCT
TGGACGTCGGACTTTTATTGCGGC -> GGACGTCGGACTTTTATTGCGGCG
GGCGGGAAATCCGTCTCTGTTCTC -> GCGGGAAATCCGTCTCTGTTCTCC
TTGGTAGCGTAGAGTTTTTTTTCC -> TGGTAGCGTAGAGTTTTTTTTCCC
CATATGTGCTGCGCGCATATTGAG -> ATATGTGCTGCGCGCATATTGAGG
CGATAGCGGCTGCTTCCATAGGCT -> GATAGCGGCTGCTTCCATAGGCTA
CGGCTGCTTCCATAGGCTAAGACG -> GGCTGCTTCCATAGGCTAAGACGC
CTTCGCCTCCGGCTTGGCGAAAAG -> TTCGCCTCCGGCTTGGCGAAAAGC
CGCTTGGACTGAACCCTTATAACG -> GCTTGGACTGAACCCTTATAACGG
CCCGCAACACAGATACCAAGAATT -> CCGCAACACAGATACCAAGAATTG
TAGTCCCGATATGGGTCCTGTCGC -> AGTCCCGATATGGGTCCTGTCGCC
TTAAGTATCTAATACGGTCCACAA -> TAAGTATCTAATACGGTCCACAAA
ATGGGTCCTGTCGCCAGGTTCACT -> TGGGTCCTGTCGCCAGGTTCACTC
AGAGACTGTGAAAATGACACGTGT -> GAGACTGTGAAAATGACACGTGTG
TCGGAACTTTAGACAAGAAAAATG -> CGGAACTTTAGACAAGAAAAATGC
TTGGCGGGACAATGTTGATCCGCA -> TGGCGGGACAATGTTGATCCGCAA
ACGGTTATAAGGTGCATTGAGATC -> CGGTTATAAGGTGCATTGAGATCA
ACTATACCTAGCCCTCTATCGGGG -> CTATACCTAGCCCTCTATCGGGGA
CGCTCTTAAACCGCAGTTTATTGT -> GCTCTTAAACCGCAGTTTATTGTA
AGTCCTGGACGTCGGACTTTTATT -> GTCCTGGACGTCGGACTTTTATTG
CGGGAAATCCGTCTCTGTTCTCCA -> GGGAAATCCGTCTCTGTTCTCCAG
GGTCCTGAAGGCTCGCATTTCGTC -> GTCCTGAAGGCTCGCATTTCGTCC
CTCTTAAACCGCAGTTTATTGTAT -> TCTTAAACCGCAGTTTATTGTATT
CTTGGAAAAAATGCACAATCGACC -> TTGGAAAAAATGCACAATCGACCC
GCATAGGAGGGTATGAACCACGAC -> CATAGGAGGGTATGAACCACGACC
CAATCCACGATAATCACATACACG -> AATCCACGATAATCACATACACGA
CTTCGCGCGACTAGACGCCGGAGG -> TTCGCGCGACTAGACGCCGGAGGC
GGTTCACTCATTAATAAGAATGTA -> GTTCACTCATTAATAAGAATGTAG
GTATCTAATACGGTCCACAAATCG -> TATCTAATACGGTCCACAAATCGG
TTATAACGGCTCTCGAAGAAACAG -> TATAACGGCTCTCGAAGAAACAGG
TCCTGGACGTCGGACTTTTATTGC -> CCTGGACGTCGGACTTTTATTGCG
CGAGAACGTCCACTTTGAAACATG -> GAGAACGTCCACTTTGAAACATGC
GGACGGTTATAAGGTGCATTGAGA -> GACGGTTATAAGGTGCATTGAGAT
AAATCGCCAGAACTCGATTTCCAT -> AATCGCCAGAACTCGATTTCCATT
CTAAGTATCCGTGCTCGATCAACG -> TAAGTATCCGTGCTCGATCAACGT
AGCCCGACATTTGGCTTGGCCAGT -> GCCCGACATTTGGCTTGGCCAGTT
AGATAGGGGGCTCCTCCACCAGCG -> GATAGGGGGCTCCTCCACCAGCGA
GTTGAAGGAGGTCGCAGCACTAGC -> TTGAAGGAGGTCGCAGCACTAGCT
GTCGAAGCTTGAGACGAGTCTGAG -> TCGAAGCTTGAGACGAGTCTGAGA
CCCAATGGGCGTTTCCATGTCTCT -> CCAATGGGCGTTTCCATGTCTCTC
ACTTTGAACATGTGAGTTCAACCA -> CTTTGAACATGTGAGTTCAACCAA
ACCCATGACGATTGTAGACGCATC -> CCCATGACGATTGTAGACGCATCG
TATCCACCGTGTCAAAGGTTATTA -> ATCCACCGTGTCAAAGGTTATTAC
CTTACAATAGTCTCCCATTTACGT -> TTACAATAGTCTCCCATTTACGTG
AATAGGCACTATACCTAGCCCTCT -> ATAGGCACTATACCTAGCCCTCTA
TTACGTGTGTCCTTCGGCGTGTTG -> TACGTGTGTCCTTCGGCGTGTTGG
ACACATTCCTATCTATTTCACGAG -> CACATTCCTATCTATTTCACGAGT
CTCGTGGTTCGGGTGATTGGTAGC -> TCGTGGTTCGGGTGATTGGTAGCG
CGCCACGTTGAAGGAGGTCGCAGC -> GCCACGTTGAAGGAGGTCGCAGCA
AGCGAACAACCCCATGAGAATCCG -> GCGAACAACCCCATGAGAATCCGA
CGCAGTTTATTGTATTCAGTTGTC -> GCAGTTTATTGTATTCAGTTGTCG
TGTAGTTATATGGGTCGCCACGTT -> GTAGTTATATGGGTCGCCACGTTG
GCCTGCATGGGTGTGACGCTTCGC -> CCTGCATGGGTGTGACGCTTCGCG
TTGGTGTTTTGCCTTTAGCTCAGG -> TGGTGTTTTGCCTTTAGCTCAGGA
TCGAAGAAACAGGAGGACGGTTAT -> CGAAGAAACAGGAGGACGGTTATA
TTCCGTATGGGCCGATACTGACCC -> TCCGTATGGGCCGATACTGACCCC
GTCGCCAGGTTCACTCATTAATAA -> TCGCCAGGTTCACTCATTAATAAG
GGCTGAATCTCACTTAGCGAACAA -> GCTGAATCTCACTTAGCGAACAAC
TAGGCTAAGACGCCGACTTTGAAC -> AGGCTAAGACGCCGACTTTGAACA
CGTCTCTGTTCTCCAGAAGATCTC -> GTCTCTGTTCTCCAGAAGATCTCG
TGTCTAGCATGGACCAACTGCTCA -> GTCTAGCATGGACCAACTGCTCAT
CCCATTTACGTGTGTCCTTCGGCG -> CCATTTACGTGTGTCCTTCGGCGT
ATCTTGGAAAAAATGCACAATCGA -> TCTTGGAAAAAATGCACAATCGAC
TATTGAGGTGTCGGCAGTCCTGGA -> ATTGAGGTGTCGGCAGTCCTGGAC
CATCGTGACCTGAGTGCTCGTTAT -> ATCGTGACCTGAGTGCTCGTTATC
GTTGTTCTCGTCGAAGCTTGAGAC -> TTGTTCTCGTCGAAGCTTGAGACG
ATGTGCGGGTCATCGCACCATAGC -> TGTGCGGGTCATCGCACCATAGCA
GGCTTGGCGAAAAGCTAAGGCTTT -> GCTTGGCGAAAAGCTAAGGCTTTT
TGACAACTGACTTTAAGCATCCCA -> GACAACTGACTTTAAGCATCCCAC
TATGTGCTGCGCGCATATTGAGGT -> ATGTGCTGCGCGCATATTGAGGTG
AAACGATCTCCGTTGTTCTCGTCG -> AACGATCTCCGTTGTTCTCGTCGA
TGGACTAAGTATCCGTGCTCGATC -> GGACTAAGTATCCGTGCTCGATCA
TATGGATATGGACGAGATTGACGT -> ATGGATATGGACGAGATTGACGTG
GTTTGTGAAATACAATTATTAGTC -> TTTGTGAAATACAATTATTAGTCC
TAATAAGAATGTAGTTATATGGGT -> AATAAGAATGTAGTTATATGGGTC
CGCTGGACCCCATCTCCACCCATG -> GCTGGACCCCATCTCCACCCATGA
CCGGAGGCACGCTGGACCCCATCT -> CGGAGGCACGCTGGACCCCATCTC
GTATGACCATACACGGGAAACGGG -> TATGACCATACACGGGAAACGGGA
TGTACTCTTGTCGGGTACTTATGG -> GTACTCTTGTCGGGTACTTATGGA
ATAAAACGATCTCCGTTGTTCTCG -> TAAAACGATCTCCGTTGTTCTCGT
TCGCACCATAGCACTACCCGCTAA -> CGCACCATAGCACTACCCGCTAAC
GGGGATGACTCCGGTTTGTGAAAT -> GGGATGACTCCGGTTTGTGAAATA
TACAGTCTCAAATCTGACGCTAGG -> ACAGTCTCAAATCTGACGCTAGGT
TCGAATTTCCCAGTTTGGTGTTTT -> CGAATTTCCCAGTTTGGTGTTTTG
TTGCATAGGAGGGTATGAACCACG -> TGCATAGGAGGGTATGAACCACGA
TTATTACATAAAACGATCTCCGTT -> TATTACATAAAACGATCTCCGTTG
TACGCCATAGCTGTGCCTGACAAC -> ACGCCATAGCTGTGCCTGACAACT
GGGGCTTTAGTTCAAGTATCCACC -> GGGCTTTAGTTCAAGTATCCACCG
CTGGGAAGAAGAAGAGGTCCTGAA -> TGGGAAGAAGAAGAGGTCCTGAAG
GAGACTGTGAAAATGACACGTGTG -> AGACTGTGAAAATGACACGTGTGC
GACCTGAGTGCTCGTTATCTAAAT -> ACCTGAGTGCTCGTTATCTAAATT
TGAAGGCTCGCATTTCGTCCGGCT -> GAAGGCTCGCATTTCGTCCGGCTT
GCTCACTTGACATGGACTAAGTAT -> CTCACTTGACATGGACTAAGTATC
GGACAATGTTGATCCGCAACGCTC -> GACAATGTTGATCCGCAACGCTCA
AAGGCTCGCATTTCGTCCGGCTTA -> AGGCTCGCATTTCGTCCGGCTTAC
TATTGAGTCATTAGCTGGGAAGAA -> ATTGAGTCATTAGCTGGGAAGAAG
CGCCGGAGGCACGCTGGACCCCAT -> GCCGGAGGCACGCTGGACCCCATC
AAACGGGAAAGGGACTTACAATAG -> AACGGGAAAGGGACTTACAATAGT
TGCGTGTGACGTTTCCCACGGGCT -> GCGTGTGACGTTTCCCACGGGCTG
GTCCTGGACGTCGGACTTTTATTG -> TCCTGGACGTCGGACTTTTATTGC
ACGCCGGAGGCACGCTGGACCCCA -> CGCCGGAGGCACGCTGGACCCCAT
ATGTAGTTATATGGGTCGCCACGT -> TGTAGTTATATGGGTCGCCACGTT
CGCCCGCCTGTCTAGCATGGACCA -> GCCCGCCTGTCTAGCATGGACCAA
ATTATTAGTCCCCTTTGGTAAATC -> TTATTAGTCCCCTTTGGTAAATCA
TTCGGCGTGTTGGCGGGACAATGT -> TCGGCGTGTTGGCGGGACAATGTT
TCGGATTATGGTATATGTGCGGGT -> CGGATTATGGTATATGTGCGGGTC
TACGTGTGTCCTTCGGCGTGTTGG -> ACGTGTGTCCTTCGGCGTGTTGGC
ATAAGAATGTAGTTATATGGGTCG -> TAAGAATGTAGTTATATGGGTCGC
TCGCCTCCGGCTTGGCGAAAAGCT -> CGCCTCCGGCTTGGCGAAAAGCTA
CTCTAGCACCTCAGTCGAGAACGT -> TCTAGCACCTCAGTCGAGAACGTC
AACACAGATACCAAGAATTGGATC -> ACACAGATACCAAGAATTGGATCA
ATTAATAAGAATGTAGTTATATGG -> TTAATAAGAATGTAGTTATATGGG
CCTGCGAACCACAGGTCGGATTAT -> CTGCGAACCACAGGTCGGATTATG
CATTAATAAGAATGTAGTTATATG -> ATTAATAAGAATGTAGTTATATGG
TGCTCATGATGAAATACCATATGT -> GCTCATGATGAAATACCATATGTG
GTGCTGCGCGCATATTGAGGTGTC -> TGCTGCGCGCATATTGAGGTGTCG
GAATCCGAATTGCAACATCGTGAC -> AATCCGAATTGCAACATCGTGACC
CGGTTGCTGGTTGCTCACTTGACA -> GGTTGCTGGTTGCTCACTTGACAT
ACTTTTATTGCGGCGGTCGAACGA -> CTTTTATTGCGGCGGTCGAACGAG
GGGACAATGTTGATCCGCAACGCT -> GGACAATGTTGATCCGCAACGCTC
GTACTTCCGGTATTTTTCGAGAGA -> TACTTCCGGTATTTTTCGAGAGAA
ATGGTATATGTGCGGGTCATCGCA -> TGGTATATGTGCGGGTCATCGCAC
GTCGGGCGGGAAATCCGTCTCTGT -> TCGGGCGGGAAATCCGTCTCTGTT
TCTGTACTCTTGTCGGGTACTTAT -> CTGTACTCTTGTCGGGTACTTATG
TACGCGTTAAGTATCTAATACGGT -> ACGCGTTAAGTATCTAATACGGTC
ACGTCGTTTACGCCATAGCTGTGC -> CGTCGTTTACGCCATAGCTGTGCC
GACCCACTGTGGCTCTAGCACCTC -> ACCCACTGTGGCTCTAGCACCTCA
CCCGCTCTTAAACCGCAGTTTATT -> CCGCTCTTAAACCGCAGTTTATTG
CAGTCCTGGACGTCGGACTTTTAT -> AGTCCTGGACGTCGGACTTTTATT
CGCGATAGCGGCTGCTTCCATAGG -> GCGATAGCGGCTGCTTCCATAGGC
AACCACGACCGCTTGGACTGAACC -> ACCACGACCGCTTGGACTGAACCC
GAACCCTTATAACGGCTCTCGAAG -> AACCCTTATAACGGCTCTCGAAGA
GACGAGATTGACGTGGCTGTGGGC -> ACGAGATTGACGTGGCTGTGGGCG
ACGTTTATTGAGTCATTAGCTGGG -> CGTTTATTGAGTCATTAGCTGGGA
CGGCGGTCGAACGAGAGTTAGTCC -> GGCGGTCGAACGAGAGTTAGTCCC
TGAATCTCACTTAGCGAACAACCC -> GAATCTCACTTAGCGAACAACCCC
TTCCGGTATTTTTCGAGAGAAGAA -> TCCGGTATTTTTCGAGAGAAGAAT
TCGGCGTGTTGGCGGGACAATGTT -> CGGCGTGTTGGCGGGACAATGTTG
CAGTTGCATAGGAGGGTATGAACC -> AGTTGCATAGGAGGGTATGAACCA
GCAACACAGATACCAAGAATTGGA -> CAACACAGATACCAAGAATTGGAT
TAGCCCTCTATCGGGGATGACTCC -> AGCCCTCTATCGGGGATGACTCCG
CAAAATACACATTCCTATCTATTT -> AAAATACACATTCCTATCTATTTC
ATCTCGTGGTTCGGGTGATTGGTA -> TCTCGTGGTTCGGGTGATTGGTAG
TGCCCAATGGGCGTTTCCATGTCT -> GCCCAATGGGCGTTTCCATGTCTC
TAGGGGGCTCCTCCACCAGCGATT -> AGGGGGCTCCTCCACCAGCGATTG
TCGTGACCTGAGTGCTCGTTATCT -> CGTGACCTGAGTGCTCGTTATCTA
GTTAACGCTGTAAAATTCCGTATG -> TTAACGCTGTAAAATTCCGTATGG
GCCCGCCTGTCTAGCATGGACCAA -> CCCGCCTGTCTAGCATGGACCAAC
GAATGTAGTTATATGGGTCGCCAC -> AATGTAGTTATATGGGTCGCCACG
GTTGTCGGCCTGCATGGGTGTGAC -> TTGTCGGCCTGCATGGGTGTGACG
CCACCGTGTCAAAGGTTATTACAT -> CACCGTGTCAAAGGTTATTACATA
GGACGTCGGACTTTTATTGCGGCG -> GACGTCGGACTTTTATTGCGGCGG
CACAATCGACCCACTGTGGCTCTA -> ACAATCGACCCACTGTGGCTCTAG
TAGCACCTCAGTCGAGAACGTCCA -> AGCACCTCAGTCGAGAACGTCCAC
CTAGCATGGACCAACTGCTCATGA -> TAGCATGGACCAACTGCTCATGAT
GTATCCACCGTGTCAAAGGTTATT -> TATCCACCGTGTCAAAGGTTATTA
GAATCTCACTTAGCGAACAACCCC -> AATCTCACTTAGCGAACAACCCCA
GAGAACGTCCACTTTGAAACATGC -> AGAACGTCCACTTTGAAACATGCC
CTCCAGAAGATCTCGTGGTTCGGG -> TCCAGAAGATCTCGTGGTTCGGGT
ATAGCACTACCCGCTAACCCGCAA -> TAGCACTACCCGCTAACCCGCAAC
CAGTTGTCGGCCTGCATGGGTGTG -> AGTTGTCGGCCTGCATGGGTGTGA
AACTTTAGACAAGAAAAATGCTTC -> ACTTTAGACAAGAAAAATGCTTCG
GCTTACGAAATTTATCGCCGCATT -> CTTACGAAATTTATCGCCGCATTC
TGAAACATGCCAATAGGCACTATA -> GAAACATGCCAATAGGCACTATAC
TCCTCGGAACTTTAGACAAGAAAA -> CCTCGGAACTTTAGACAAGAAAAA
CAATTCCCGCTCTTAAACCGCAGT -> AATTCCCGCTCTTAAACCGCAGTT
GCGATGGGGCTTTAGTTCAAGTAT -> CGATGGGGCTTTAGTTCAAGTATC
GGGACTTACAATAGTCTCCCATTT -> GGACTTACAATAGTCTCCCATTTA
TCGCCAGAACTCGATTTCCATTCG -> CGCCAGAACTCGATTTCCATTCGA
GGAAATCCGTCTCTGTTCTCCAGA -> GAAATCCGTCTCTGTTCTCCAGAA
CTTAAACCGCAGTTTATTGTATTC -> TTAAACCGCAGTTTATTGTATTCA
CGACTTTGAACATGTGAGTTCAAC -> GACTTTGAACATGTGAGTTCAACC
CTGGACCCCATCTCCACCCATGAC -> TGGACCCCATCTCCACCCATGACG
ACCATAGCACTACCCGCTAACCCG -> CCATAGCACTACCCGCTAACCCGC
ACGTCAAAATACACATTCCTATCT -> CGTCAAAATACACATTCCTATCTA
TTGTCGGGTACTTATGGATATGGA -> TGTCGGGTACTTATGGATATGGAC
GCTCCTGCGAACCACAGGTCGGAT -> CTCCTGCGAACCACAGGTCGGATT
CCATGACGATTGTAGACGCATCGA -> CATGACGATTGTAGACGCATCGAG
CGTCGTTTACGCCATAGCTGTGCC -> GTCGTTTACGCCATAGCTGTGCCT
AATCGGTTGCTGGTTGCTCACTTG -> ATCGGTTGCTGGTTGCTCACTTGA
ACGGGAAACGGGAAAGGGACTTAC -> CGGGAAACGGGAAAGGGACTTACA
CACTCATTAATAAGAATGTAGTTA -> ACTCATTAATAAGAATGTAGTTAT
GCATTGAGATCACACAACATCTCT -> CATTGAGATCACACAACATCTCTT
CGGAACTTTAGACAAGAAAAATGC -> GGAACTTTAGACAAGAAAAATGCT
GCTCGAATTTCCCAGTTTGGTGTT -> CTCGAATTTCCCAGTTTGGTGTTT
AAGAAGAAGAGGTCCTGAAGGCTC -> AGAAGAAGAGGTCCTGAAGGCTCG
CGTGACCTGAGTGCTCGTTATCTA -> GTGACCTGAGTGCTCGTTATCTAA
CAATGGGCGTTTCCATGTCTCTCT -> AATGGGCGTTTCCATGTCTCTCTA
ATAGGAGGGTATGAACCACGACCG -> TAGGAGGGTATGAACCACGACCGC
ACCGGCATGGGCGATACAGCCCGA -> CCGGCATGGGCGATACAGCCCGAC
TCATTAGCTGGGAAGAAGAAGAGG -> CATTAGCTGGGAAGAAGAAGAGGT
AACTCGATTTCCATTCGAGAACTA -> ACTCGATTTCCATTCGAGAACTAA
TACGGTCCACAAATCGGTTGCTGG -> ACGGTCCACAAATCGGTTGCTGGT
CCTATCTATTTCACGAGTACGTTA -> CTATCTATTTCACGAGTACGTTAA
CTAACGGTGTGGCGAACGTCAAAA -> TAACGGTGTGGCGAACGTCAAAAT
TATTGCGGCGGTCGAACGAGAGTT -> ATTGCGGCGGTCGAACGAGAGTTA
CCGGTTTGTGAAATACAATTATTA -> CGGTTTGTGAAATACAATTATTAG
AAATCTGACGCTAGGTCCACACGT -> AATCTGACGCTAGGTCCACACGTC
TCGGCAGTCCTGGACGTCGGACTT -> CGGCAGTCCTGGACGTCGGACTTT
ATTCCGTATGGGCCGATACTGACC -> TTCCGTATGGGCCGATACTGACCC
ATACGGTCCACAAATCGGTTGCTG -> TACGGTCCACAAATCGGTTGCTGG
CTGGACCCGCTACAGTCTCAAATC -> TGGACCCGCTACAGTCTCAAATCT
AAGATCTCGTGGTTCGGGTGATTG -> AGATCTCGTGGTTCGGGTGATTGG
TTAAATCGCCAGAACTCGATTTCC -> TAAATCGCCAGAACTCGATTTCCA
TATAACGGCTCTCGAAGAAACAGG -> ATAACGGCTCTCGAAGAAACAGGA
GGCTGTGGGCGGCTGCATAGCAGA -> GCTGTGGGCGGCTGCATAGCAGAA
ATCGCCGCATTCACATAAGTCACG -> TCGCCGCATTCACATAAGTCACGC
TTACGAAATTTATCGCCGCATTCA -> TACGAAATTTATCGCCGCATTCAC
GGGTCGCCACGTTGAAGGAGGTCG -> GGTCGCCACGTTGAAGGAGGTCGC
ACCTGAGTGCTCGTTATCTAAATT -> CCTGAGTGCTCGTTATCTAAATTC
CTCGATTTCCATTCGAGAACTAAC -> TCGATTTCCATTCGAGAACTAACG
TCTTGGGTCCCCGTGCGATGGGGC -> CTTGGGTCCCCGTGCGATGGGGCT
TGGTAGCGTAGAGTTTTTTTTCCC -> GGTAGCGTAGAGTTTTTTTTCCCG
GGACTGAACCCTTATAACGGCTCT -> GACTGAACCCTTATAACGGCTCTC
TGGGGCTTTAGTTCAAGTATCCAC -> GGGGCTTTAGTTCAAGTATCCACC
ATTTCCATTCGAGAACTAACGGTG -> TTTCCATTCGAGAACTAACGGTGT
TCCATAGGCTAAGACGCCGACTTT -> CCATAGGCTAAGACGCCGACTTTG
CACAAATCGGTTGCTGGTTGCTCA -> ACAAATCGGTTGCTGGTTGCTCAC
TAGCGGCTGCTTCCATAGGCTAAG -> AGCGGCTGCTTCCATAGGCTAAGA
CGCTGTAAAATTCCGTATGGGCCG -> GCTGTAAAATTCCGTATGGGCCGA
TCCGGCTTGGCGAAAAGCTAAGGC -> CCGGCTTGGCGAAAAGCTAAGGCT
ACGAGTCTGAGAGACTGTGAAAAT -> CGAGTCTGAGAGACTGTGAAAATG
ACGAATTACTAGATAGGGGGCTCC -> CGAATTACTAGATAGGGGGCTCCT
GTGAAAATGACACGTGTGCCCAAT -> TGAAAATGACACGTGTGCCCAATG
CTGGTTGCTCACTTGACATGGACT -> TGGTTGCTCACTTGACATGGACTA
GCGTTAAGTATCTAATACGGTCCA -> CGTTAAGTATCTAATACGGTCCAC
ACTCTTGTCGGGTACTTATGGATA -> CTCTTGTCGGGTACTTATGGATAT
GTTTACGCCATAGCTGTGCCTGAC -> TTTACGCCATAGCTGTGCCTGACA
TATTTTTCGAGAGAAGAATGTGTC -> ATTTTTCGAGAGAAGAATGTGTCT
TCTCTGTTCTCCAGAAGATCTCGT -> CTCTGTTCTCCAGAAGATCTCGTG
CTTACGAAATTTATCGCCGCATTC -> TTACGAAATTTATCGCCGCATTCA
TCTCTATATTTAAATCGCCAGAAC -> CTCTATATTTAAATCGCCAGAACT
ACCCGCTAACCCGCAACACAGATA -> CCCGCTAACCCGCAACACAGATAC
GGCACTATACCTAGCCCTCTATCG -> GCACTATACCTAGCCCTCTATCGG
GTAAAATTCCGTATGGGCCGATAC -> TAAAATTCCGTATGGGCCGATACT
TCCACAAATCGGTTGCTGGTTGCT -> CCACAAATCGGTTGCTGGTTGCTC
CGAGTCTGAGAGACTGTGAAAATG -> GAGTCTGAGAGACTGTGAAAATGA
TTGGGTCCCCGTGCGATGGGGCTT -> TGGGTCCCCGTGCGATGGGGCTTT
CGCTACAGTCTCAAATCTGACGCT -> GCTACAGTCTCAAATCTGACGCTA
GCTTCCATAGGCTAAGACGCCGAC -> CTTCCATAGGCTAAGACGCCGACT
TGCGGGTCATCGCACCATAGCACT -> GCGGGTCATCGCACCATAGCACTA
AGAATGTAGTTATATGGGTCGCCA -> GAATGTAGTTATATGGGTCGCCAC
AACATGTGAGTTCAACCAAGACAT -> ACATGTGAGTTCAACCAAGACATG
CCTCTATCGGGGATGACTCCGGTT -> CTCTATCGGGGATGACTCCGGTTT
CACCAGCGATTGCGTGTGACGTTT -> ACCAGCGATTGCGTGTGACGTTTC
GTTATATGGGTCGCCACGTTGAAG -> TTATATGGGTCGCCACGTTGAAGG
GGACCGGCATGGGCGATACAGCCC -> GACCGGCATGGGCGATACAGCCCG
GAAGGTCCTCGGAACTTTAGACAA -> AAGGTCCTCGGAACTTTAGACAAG
CCTAGCCCTCTATCGGGGATGACT -> CTAGCCCTCTATCGGGGATGACTC
GACCGCTTGGACTGAACCCTTATA -> ACCGCTTGGACTGAACCCTTATAA
TACCATATGTGCTGCGCGCATATT -> ACCATATGTGCTGCGCGCATATTG
GGCTCGCATTTCGTCCGGCTTACG -> GCTCGCATTTCGTCCGGCTTACGA
CACGATAATCACATACACGAAGTT -> ACGATAATCACATACACGAAGTTT
GATACCAAGAATTGGATCAGAACA -> ATACCAAGAATTGGATCAGAACAG
AATTCCGTATGGGCCGATACTGAC -> ATTCCGTATGGGCCGATACTGACC
TTATGGATATGGACGAGATTGACG -> TATGGATATGGACGAGATTGACGT
GTGTCTGTACTCTTGTCGGGTACT -> TGTCTGTACTCTTGTCGGGTACTT
TGGACTGAACCCTTATAACGGCTC -> GGACTGAACCCTTATAACGGCTCT
GTCTAGCATGGACCAACTGCTCAT -> TCTAGCATGGACCAACTGCTCATG
AGTTAGTCCCGATATGGGTCCTGT -> GTTAGTCCCGATATGGGTCCTGTC
ATGGAGACTCTTGGGTCCCCGTGC -> TGGAGACTCTTGGGTCCCCGTGCG
GGGAAACGGGAAAGGGACTTACAA -> GGAAACGGGAAAGGGACTTACAAT
GAAATTTATCGCCGCATTCACATA -> AAATTTATCGCCGCATTCACATAA
ACTCGATTTCCATTCGAGAACTAA -> CTCGATTTCCATTCGAGAACTAAC
ATGGTACTTCCGGTATTTTTCGAG -> TGGTACTTCCGGTATTTTTCGAGA
ACCAAGACATGGTACTTCCGGTAT -> CCAAGACATGGTACTTCCGGTATT
ACTTCCGGTATTTTTCGAGAGAAG -> CTTCCGGTATTTTTCGAGAGAAGA
TAGATAGGGGGCTCCTCCACCAGC -> AGATAGGGGGCTCCTCCACCAGCG
GAAGCTCGAATTTCCCAGTTTGGT -> AAGCTCGAATTTCCCAGTTTGGTG
GTCCCCTTTGGTAAATCAATCCAC -> TCCCCTTTGGTAAATCAATCCACG
AATCGCCAGAACTCGATTTCCATT -> ATCGCCAGAACTCGATTTCCATTC
ATATGTGCTGCGCGCATATTGAGG -> TATGTGCTGCGCGCATATTGAGGT
CCGCTAACCCGCAACACAGATACC -> CGCTAACCCGCAACACAGATACCA
TGTCGGGTACTTATGGATATGGAC -> GTCGGGTACTTATGGATATGGACG
ACGAAATTTATCGCCGCATTCACA -> CGAAATTTATCGCCGCATTCACAT
AAACCGCAGTTTATTGTATTCAGT -> AACCGCAGTTTATTGTATTCAGTT
GTGAGTATTACGCGTTAAGTATCT -> TGAGTATTACGCGTTAAGTATCTA
TCGATCAACGTTTATTGAGTCATT -> CGATCAACGTTTATTGAGTCATTA
TTGAAGGAGGTCGCAGCACTAGCT -> TGAAGGAGGTCGCAGCACTAGCTC
TGTCGGCAGTCCTGGACGTCGGAC -> GTCGGCAGTCCTGGACGTCGGACT
GGGCGATACAGCCCGACATTTGGC -> GGCGATACAGCCCGACATTTGGCT
TGAGATCACACAACATCTCTTCTC -> GAGATCACACAACATCTCTTCTCT
CAAAGGTTATTACATAAAACGATC -> AAAGGTTATTACATAAAACGATCT
ATCGTGACCTGAGTGCTCGTTATC -> TCGTGACCTGAGTGCTCGTTATCT
AATTTATCGCCGCATTCACATAAG -> ATTTATCGCCGCATTCACATAAGT
CTGACAACTGACTTTAAGCATCCC -> TGACAACTGACTTTAAGCATCCCA
AACCAAGACATGGTACTTCCGGTA -> ACCAAGACATGGTACTTCCGGTAT
ATCTAATACGGTCCACAAATCGGT -> TCTAATACGGTCCACAAATCGGTT
CTTTTATTGCGGCGGTCGAACGAG -> TTTTATTGCGGCGGTCGAACGAGA
GATTATGGTATATGTGCGGGTCAT -> ATTATGGTATATGTGCGGGTCATC
GCGGCTGCTTCCATAGGCTAAGAC -> CGGCTGCTTCCATAGGCTAAGACG
CGATACAGCCCGACATTTGGCTTG -> GATACAGCCCGACATTTGGCTTGG
AGTTGTCGGCCTGCATGGGTGTGA -> GTTGTCGGCCTGCATGGGTGTGAC
GAGACAAGCATGGAGACTCTTGGG -> AGACAAGCATGGAGACTCTTGGGT
ACGTGGCTGTGGGCGGCTGCATAG -> CGTGGCTGTGGGCGGCTGCATAGC
CCAAGACATGGTACTTCCGGTATT -> CAAGACATGGTACTTCCGGTATTT
GACTGAACCCTTATAACGGCTCTC -> ACTGAACCCTTATAACGGCTCTCG
GAGTTCAACCAAGACATGGTACTT -> AGTTCAACCAAGACATGGTACTTC
ACATTCCTATCTATTTCACGAGTA -> CATTCCTATCTATTTCACGAGTAC
CACTTTGAAACATGCCAATAGGCA -> ACTTTGAAACATGCCAATAGGCAC
CGCGCATATTGAGGTGTCGGCAGT -> GCGCATATTGAGGTGTCGGCAGTC
TGACCCCTGGACCCGCTACAGTCT -> GACCCCTGGACCCGCTACAGTCTC
GCTCTTAAACCGCAGTTTATTGTA -> CTCTTAAACCGCAGTTTATTGTAT
GAAATCCGTCTCTGTTCTCCAGAA -> AAATCCGTCTCTGTTCTCCAGAAG
AGGAGGACGGTTATAAGGTGCATT -> GGAGGACGGTTATAAGGTGCATTG
CTAGCCCTCTATCGGGGATGACTC -> TAGCCCTCTATCGGGGATGACTCC
AGTGCTCGTTATCTAAATTCGCCC -> GTGCTCGTTATCTAAATTCGCCCG
AGGCACGCTGGACCCCATCTCCAC -> GGCACGCTGGACCCCATCTCCACC
GAGGCGACGTCGTTTACGCCATAG -> AGGCGACGTCGTTTACGCCATAGC
TCCACTTTGAAACATGCCAATAGG -> CCACTTTGAAACATGCCAATAGGC
AACGGGAAAGGGACTTACAATAGT -> ACGGGAAAGGGACTTACAATAGTC
CAACATCTCTTCTCTTCTTGGGTG -> AACATCTCTTCTCTTCTTGGGTGG
AGACAAGCATGGAGACTCTTGGGT -> GACAAGCATGGAGACTCTTGGGTC
ATGGGGCTTTAGTTCAAGTATCCA -> TGGGGCTTTAGTTCAAGTATCCAC
GGCGGGACAATGTTGATCCGCAAC -> GCGGGACAATGTTGATCCGCAACG
GGTAAATCAATCCACGATAATCAC -> GTAAATCAATCCACGATAATCACA
AGAAGGTCCTCGGAACTTTAGACA -> GAAGGTCCTCGGAACTTTAGACAA
TTGAGGTGTCGGCAGTCCTGGACG -> TGAGGTGTCGGCAGTCCTGGACGT
CCGGTATTTTTCGAGAGAAGAATG -> CGGTATTTTTCGAGAGAAGAATGT
CGTCGAGACGAATTACTAGATAGG -> GTCGAGACGAATTACTAGATAGGG
TTGCAACATCGTGACCTGAGTGCT -> TGCAACATCGTGACCTGAGTGCTC
CTTGGCCAGTTGCATAGGAGGGTA -> TTGGCCAGTTGCATAGGAGGGTAT
CAATGTTGATCCGCAACGCTCACC -> AATGTTGATCCGCAACGCTCACCC
CATGGAGACTCTTGGGTCCCCGTG -> ATGGAGACTCTTGGGTCCCCGTGC
AGGCACTATACCTAGCCCTCTATC -> GGCACTATACCTAGCCCTCTATCG
ATAGCAGAAGGTCCTCGGAACTTT -> TAGCAGAAGGTCCTCGGAACTTTA
GGTACTTCCGGTATTTTTCGAGAG -> GTACTTCCGGTATTTTTCGAGAGA
ACATGGACTAAGTATCCGTGCTCG -> CATGGACTAAGTATCCGTGCTCGA
AAGAATGTAGTTATATGGGTCGCC -> AGAATGTAGTTATATGGGTCGCCA
TTATTGCGGCGGTCGAACGAGAGT -> TATTGCGGCGGTCGAACGAGAGTT
TAATCACATACACGAAGTTTCGAG -> AATCACATACACGAAGTTTCGAGG
CGACCCACTGTGGCTCTAGCACCT -> GACCCACTGTGGCTCTAGCACCTC
ATTACATAAAACGATCTCCGTTGT -> TTACATAAAACGATCTCCGTTGTT
TGACGCTTCGCGCGACTAGACGCC -> GACGCTTCGCGCGACTAGACGCCG
TCACTCATTAATAAGAATGTAGTT -> CACTCATTAATAAGAATGTAGTTA
GCTGGGAAGAAGAAGAGGTCCTGA -> CTGGGAAGAAGAAGAGGTCCTGAA
CCTCGGAACTTTAGACAAGAAAAA -> CTCGGAACTTTAGACAAGAAAAAT
GGCTCTCGAAGAAACAGGAGGACG -> GCTCTCGAAGAAACAGGAGGACGG
ATGACTCCGGTTTGTGAAATACAA -> TGACTCCGGTTTGTGAAATACAAT
AGTATCCACCGTGTCAAAGGTTAT -> GTATCCACCGTGTCAAAGGTTATT
TTTAGTTCAAGTATCCACCGTGTC -> TTAGTTCAAGTATCCACCGTGTCA
CGTTGAAGGAGGTCGCAGCACTAG -> GTTGAAGGAGGTCGCAGCACTAGC
TGATTGGTAGCGTAGAGTTTTTTT -> GATTGGTAGCGTAGAGTTTTTTTT
GGAAAAAATGCACAATCGACCCAC -> GAAAAAATGCACAATCGACCCACT
ACCATATGTGCTGCGCGCATATTG -> CCATATGTGCTGCGCGCATATTGA
AACGATCTCCGTTGTTCTCGTCGA -> ACGATCTCCGTTGTTCTCGTCGAA
GGCTTACGAAATTTATCGCCGCAT -> GCTTACGAAATTTATCGCCGCATT
GCGATAGCGGCTGCTTCCATAGGC -> CGATAGCGGCTGCTTCCATAGGCT
AAATTCGCCCGCCTGTCTAGCATG -> AATTCGCCCGCCTGTCTAGCATGG
ACGGTGTGGCGAACGTCAAAATAC -> CGGTGTGGCGAACGTCAAAATACA
GCACAATCGACCCACTGTGGCTCT -> CACAATCGACCCACTGTGGCTCTA
CACTGTGGCTCTAGCACCTCAGTC -> ACTGTGGCTCTAGCACCTCAGTCG
ATTGGATCAGAACAGCAGCGGACC -> TTGGATCAGAACAGCAGCGGACCG
CGGCTTGGCGAAAAGCTAAGGCTT -> GGCTTGGCGAAAAGCTAAGGCTTT
GTCCTTCGGCGTGTTGGCGGGACA -> TCCTTCGGCGTGTTGGCGGGACAA
CATCGCACCATAGCACTACCCGCT -> ATCGCACCATAGCACTACCCGCTA
TCAAAGGTTATTACATAAAACGAT -> CAAAGGTTATTACATAAAACGATC
TGGCGGGACAATGTTGATCCGCAA -> GGCGGGACAATGTTGATCCGCAAC
AATGTAGTTATATGGGTCGCCACG -> ATGTAGTTATATGGGTCGCCACGT
AGACTCTTGGGTCCCCGTGCGATG -> GACTCTTGGGTCCCCGTGCGATGG
GCTTGGCCAGTTGCATAGGAGGGT -> CTTGGCCAGTTGCATAGGAGGGTA
GTGGCTCTAGCACCTCAGTCGAGA -> TGGCTCTAGCACCTCAGTCGAGAA
TTGAGACGAGTCTGAGAGACTGTG -> TGAGACGAGTCTGAGAGACTGTGA
CGCTAACCCGCAACACAGATACCA -> GCTAACCCGCAACACAGATACCAA
GATAGGGGGCTCCTCCACCAGCGA -> ATAGGGGGCTCCTCCACCAGCGAT
CGGTCCACAAATCGGTTGCTGGTT -> GGTCCACAAATCGGTTGCTGGTTG
GTTGCTCACTTGACATGGACTAAG -> TTGCTCACTTGACATGGACTAAGT
GTGCTCGATCAACGTTTATTGAGT -> TGCTCGATCAACGTTTATTGAGTC
TGGTTCGGGTGATTGGTAGCGTAG -> GGTTCGGGTGATTGGTAGCGTAGA
TTCGCCTCCGGCTTGGCGAAAAGC -> TCGCCTCCGGCTTGGCGAAAAGCT
GTCTCAAATCTGACGCTAGGTCCA -> TCTCAAATCTGACGCTAGGTCCAC
TTATTGTATTCAGTTGTCGGCCTG -> TATTGTATTCAGTTGTCGGCCTGC
GCTGTGCCTGACAACTGACTTTAA -> CTGTGCCTGACAACTGACTTTAAG
GATCTCGTGGTTCGGGTGATTGGT -> ATCTCGTGGTTCGGGTGATTGGTA
CGACACACTCAGTGAGTATTACGC -> GACACACTCAGTGAGTATTACGCG
TTTATCGCCGCATTCACATAAGTC -> TTATCGCCGCATTCACATAAGTCA
TGGACGAGATTGACGTGGCTGTGG -> GGACGAGATTGACGTGGCTGTGGG
ACCCTTAGATCAATTCCCGCTCTT -> CCCTTAGATCAATTCCCGCTCTTA
ATTCCTATCTATTTCACGAGTACG -> TTCCTATCTATTTCACGAGTACGT
CAGGAGGACGGTTATAAGGTGCAT -> AGGAGGACGGTTATAAGGTGCATT
CCACGTTGAAGGAGGTCGCAGCAC -> CACGTTGAAGGAGGTCGCAGCACT
TGAGACGAGTCTGAGAGACTGTGA -> GAGACGAGTCTGAGAGACTGTGAA
TTTAAGCATCCCACCGACACACTC -> TTAAGCATCCCACCGACACACTCA
GGGCTTTAGTTCAAGTATCCACCG -> GGCTTTAGTTCAAGTATCCACCGT
AATCCACGATAATCACATACACGA -> ATCCACGATAATCACATACACGAA
CACAGGTCGGATTATGGTATATGT -> ACAGGTCGGATTATGGTATATGTG
CGCACCATAGCACTACCCGCTAAC -> GCACCATAGCACTACCCGCTAACC
TACCCGCTAACCCGCAACACAGAT -> ACCCGCTAACCCGCAACACAGATA
TAGCTCAGGATGTATGACCATACA -> AGCTCAGGATGTATGACCATACAC
GGAGGGTATGAACCACGACCGCTT -> GAGGGTATGAACCACGACCGCTTG
TTTTTTCCCGCGAAGCTCGAATTT -> TTTTTCCCGCGAAGCTCGAATTTC
TGCCTGACAACTGACTTTAAGCAT -> GCCTGACAACTGACTTTAAGCATC
ATATGGACGAGATTGACGTGGCTG -> TATGGACGAGATTGACGTGGCTGT
TATTACGCGTTAAGTATCTAATAC -> ATTACGCGTTAAGTATCTAATACG
GGTGTGGCGAACGTCAAAATACAC -> GTGTGGCGAACGTCAAAATACACA
ACACGGGAAACGGGAAAGGGACTT -> CACGGGAAACGGGAAAGGGACTTA
CTTTAGTTCAAGTATCCACCGTGT -> TTTAGTTCAAGTATCCACCGTGTC
TAACGCTGTAAAATTCCGTATGGG -> AACGCTGTAAAATTCCGTATGGGC
AACAGGAGGACGGTTATAAGGTGC -> ACAGGAGGACGGTTATAAGGTGCA
CGCCAGAACTCGATTTCCATTCGA -> GCCAGAACTCGATTTCCATTCGAG
GATCAGAACAGCAGCGGACCGGCA -> ATCAGAACAGCAGCGGACCGGCAT
TGGCGAACGTCAAAATACACATTC -> GGCGAACGTCAAAATACACATTCC
ACAATAGTCTCCCATTTACGTGTG -> CAATAGTCTCCCATTTACGTGTGT
ATATGGGTCCTGTCGCCAGGTTCA -> TATGGGTCCTGTCGCCAGGTTCAC
AGGTCCACACGTCGAGACGAATTA -> GGTCCACACGTCGAGACGAATTAC
CGAGGCGACGTCGTTTACGCCATA -> GAGGCGACGTCGTTTACGCCATAG
ACAGGTCGGATTATGGTATATGTG -> CAGGTCGGATTATGGTATATGTGC
TAGCTCCTGCGAACCACAGGTCGG -> AGCTCCTGCGAACCACAGGTCGGA
GGATTATGGTATATGTGCGGGTCA -> GATTATGGTATATGTGCGGGTCAT
TCTTGTCGGGTACTTATGGATATG -> CTTGTCGGGTACTTATGGATATGG
CTGTGGGCGGCTGCATAGCAGAAG -> TGTGGGCGGCTGCATAGCAGAAGG
TTTTCCCGCGAAGCTCGAATTTCC -> TTTCCCGCGAAGCTCGAATTTCCC
CGTCCGGCTTACGAAATTTATCGC -> GTCCGGCTTACGAAATTTATCGCC
AGCCCTCTATCGGGGATGACTCCG -> GCCCTCTATCGGGGATGACTCCGG
GTGCCTGACAACTGACTTTAAGCA -> TGCCTGACAACTGACTTTAAGCAT
TTTACGTGTGTCCTTCGGCGTGTT -> TTACGTGTGTCCTTCGGCGTGTTG
TTAGTCCCGATATGGGTCCTGTCG -> TAGTCCCGATATGGGTCCTGTCGC
GAAAAATGCTTCGCCTCCGGCTTG -> AAAAATGCTTCGCCTCCGGCTTGG
TCCCAGTTTGGTGTTTTGCCTTTA -> CCCAGTTTGGTGTTTTGCCTTTAG
CCCGCCTGTCTAGCATGGACCAAC -> CCGCCTGTCTAGCATGGACCAACT
TCGTGGTTCGGGTGATTGGTAGCG -> CGTGGTTCGGGTGATTGGTAGCGT
CCACTGTGGCTCTAGCACCTCAGT -> CACTGTGGCTCTAGCACCTCAGTC
ACAATCGACCCACTGTGGCTCTAG -> CAATCGACCCACTGTGGCTCTAGC
ATTACGCGTTAAGTATCTAATACG -> TTACGCGTTAAGTATCTAATACGG
AAGAAGAGGTCCTGAAGGCTCGCA -> AGAAGAGGTCCTGAAGGCTCGCAT
CCATCTCCACCCATGACGATTGTA -> CATCTCCACCCATGACGATTGTAG
GTTGGCGGGACAATGTTGATCCGC -> TTGGCGGGACAATGTTGATCCGCA
GGCCTGCATGGGTGTGACGCTTCG -> GCCTGCATGGGTGTGACGCTTCGC
GCTTGGCGAAAAGCTAAGGCTTTT -> CTTGGCGAAAAGCTAAGGCTTTTC
GAAGGCTCGCATTTCGTCCGGCTT -> AAGGCTCGCATTTCGTCCGGCTTA
GTCGGGTACTTATGGATATGGACG -> TCGGGTACTTATGGATATGGACGA
GGTCCACACGTCGAGACGAATTAC -> GTCCACACGTCGAGACGAATTACT
ATGGGTGTGACGCTTCGCGCGACT -> TGGGTGTGACGCTTCGCGCGACTA
TGTTTTGCCTTTAGCTCAGGATGT -> GTTTTGCCTTTAGCTCAGGATGTA
TGTGACGCTTCGCGCGACTAGACG -> GTGACGCTTCGCGCGACTAGACGC
CACTTAGCGAACAACCCCATGAGA -> ACTTAGCGAACAACCCCATGAGAA
AAGACGCCGACTTTGAACATGTGA -> AGACGCCGACTTTGAACATGTGAG
GTTCTCCAGAAGATCTCGTGGTTC -> TTCTCCAGAAGATCTCGTGGTTCG
ATTGAGGTGTCGGCAGTCCTGGAC -> TTGAGGTGTCGGCAGTCCTGGACG
TTGAAACATGCCAATAGGCACTAT -> TGAAACATGCCAATAGGCACTATA
TTCTCGTCGAAGCTTGAGACGAGT -> TCTCGTCGAAGCTTGAGACGAGTC
TGTGCTGCGCGCATATTGAGGTGT -> GTGCTGCGCGCATATTGAGGTGTC
GGTATGAACCACGACCGCTTGGAC -> GTATGAACCACGACCGCTTGGACT
TTGGTAAATCAATCCACGATAATC -> TGGTAAATCAATCCACGATAATCA
TGTTCTCGTCGAAGCTTGAGACGA -> GTTCTCGTCGAAGCTTGAGACGAG
GCTTCGCCTCCGGCTTGGCGAAAA -> CTTCGCCTCCGGCTTGGCGAAAAG
CGCAACACAGATACCAAGAATTGG -> GCAACACAGATACCAAGAATTGGA
TTATTAGTCCCCTTTGGTAAATCA -> TATTAGTCCCCTTTGGTAAATCAA
CTCTATCGGGGATGACTCCGGTTT -> TCTATCGGGGATGACTCCGGTTTG
CCCAGTTTGGTGTTTTGCCTTTAG -> CCAGTTTGGTGTTTTGCCTTTAGC
TCAAAATACACATTCCTATCTATT -> CAAAATACACATTCCTATCTATTT
AGTACGTTAACGCTGTAAAATTCC -> GTACGTTAACGCTGTAAAATTCCG
CTATCGGGGATGACTCCGGTTTGT -> TATCGGGGATGACTCCGGTTTGTG
GAAACATGCCAATAGGCACTATAC -> AAACATGCCAATAGGCACTATACC
GGTTATTACATAAAACGATCTCCG -> GTTATTACATAAAACGATCTCCGT
ACAACTGACTTTAAGCATCCCACC -> CAACTGACTTTAAGCATCCCACCG
TTCGAGAGAAGAATGTGTCTGTAC -> TCGAGAGAAGAATGTGTCTGTACT
ACCCCTGGACCCGCTACAGTCTCA -> CCCCTGGACCCGCTACAGTCTCAA
CGTTTCCCACGGGCTGAATCTCAC -> GTTTCCCACGGGCTGAATCTCACT
CCATACACGGGAAACGGGAAAGGG -> CATACACGGGAAACGGGAAAGGGA
GCTGTAAAATTCCGTATGGGCCGA -> CTGTAAAATTCCGTATGGGCCGAT
CTAGCTCCTGCGAACCACAGGTCG -> TAGCTCCTGCGAACCACAGGTCGG
CAACTGACTTTAAGCATCCCACCG -> AACTGACTTTAAGCATCCCACCGA
TTTTTTTCCCGCGAAGCTCGAATT -> TTTTTTCCCGCGAAGCTCGAATTT
CAAGAATTGGATCAGAACAGCAGC -> AAGAATTGGATCAGAACAGCAGCG
TGGGCGGCTGCATAGCAGAAGGTC -> GGGCGGCTGCATAGCAGAAGGTCC
GTTAGTCCCGATATGGGTCCTGTC -> TTAGTCCCGATATGGGTCCTGTCG
GATGACTCCGGTTTGTGAAATACA -> ATGACTCCGGTTTGTGAAATACAA
TCCCGCTCTTAAACCGCAGTTTAT -> CCCGCTCTTAAACCGCAGTTTATT
ACTAGCTCCTGCGAACCACAGGTC -> CTAGCTCCTGCGAACCACAGGTCG
TCACTTGACATGGACTAAGTATCC -> CACTTGACATGGACTAAGTATCCG
TATTTCACGAGTACGTTAACGCTG -> ATTTCACGAGTACGTTAACGCTGT
TGTCTCTCTATATTTAAATCGCCA -> GTCTCTCTATATTTAAATCGCCAG
CAATCGACCCACTGTGGCTCTAGC -> AATCGACCCACTGTGGCTCTAGCA
AGGTTATTACATAAAACGATCTCC -> GGTTATTACATAAAACGATCTCCG
TTTGAACATGTGAGTTCAACCAAG -> TTGAACATGTGAGTTCAACCAAGA
TGCACAATCGACCCACTGTGGCTC -> GCACAATCGACCCACTGTGGCTCT
TGACCATACACGGGAAACGGGAAA -> GACCATACACGGGAAACGGGAAAG
CAACATCGTGACCTGAGTGCTCGT -> AACATCGTGACCTGAGTGCTCGTT
GAATTACTAGATAGGGGGCTCCTC -> AATTACTAGATAGGGGGCTCCTCC
ATTCACATAAGTCACGCGATAGCG -> TTCACATAAGTCACGCGATAGCGG
AGAACTCGATTTCCATTCGAGAAC -> GAACTCGATTTCCATTCGAGAACT
GGAAACGGGAAAGGGACTTACAAT -> GAAACGGGAAAGGGACTTACAATA
AGACGCCGACTTTGAACATGTGAG -> GACGCCGACTTTGAACATGTGAGT
ACGGGAAAGGGACTTACAATAGTC -> CGGGAAAGGGACTTACAATAGTCT
CGCTAGGTCCACACGTCGAGACGA -> GCTAGGTCCACACGTCGAGACGAA
CGAGAACTAACGGTGTGGCGAACG -> GAGAACTAACGGTGTGGCGAACGT
CTGAACCCTTATAACGGCTCTCGA -> TGAACCCTTATAACGGCTCTCGAA
TTTCACGAGTACGTTAACGCTGTA -> TTCACGAGTACGTTAACGCTGTAA
TCACGCGATAGCGGCTGCTTCCAT -> CACGCGATAGCGGCTGCTTCCATA
TTACAATAGTCTCCCATTTACGTG -> TACAATAGTCTCCCATTTACGTGT
CTTCCATAGGCTAAGACGCCGACT -> TTCCATAGGCTAAGACGCCGACTT
AACCCTTATAACGGCTCTCGAAGA -> ACCCTTATAACGGCTCTCGAAGAA
ACGTTGAAGGAGGTCGCAGCACTA -> CGTTGAAGGAGGTCGCAGCACTAG
CTCCGGCTTGGCGAAAAGCTAAGG -> TCCGGCTTGGCGAAAAGCTAAGGC
CCCACCGACACACTCAGTGAGTAT -> CCACCGACACACTCAGTGAGTATT
CGTGTTGGCGGGACAATGTTGATC -> GTGTTGGCGGGACAATGTTGATCC
GGCCGATACTGACCCCTGGACCCG -> GCCGATACTGACCCCTGGACCCGC
TCGCCACGTTGAAGGAGGTCGCAG -> CGCCACGTTGAAGGAGGTCGCAGC
GAACATGTGAGTTCAACCAAGACA -> AACATGTGAGTTCAACCAAGACAT
TTCCCGCTCTTAAACCGCAGTTTA -> TCCCGCTCTTAAACCGCAGTTTAT
CTGACTTTAAGCATCCCACCGACA -> TGACTTTAAGCATCCCACCGACAC
TAAATCAATCCACGATAATCACAT -> AAATCAATCCACGATAATCACATA
GCATTCACATAAGTCACGCGATAG -> CATTCACATAAGTCACGCGATAGC
CGTTGTTCTCGTCGAAGCTTGAGA -> GTTGTTCTCGTCGAAGCTTGAGAC
GCAGCACTAGCTCCTGCGAACCAC -> CAGCACTAGCTCCTGCGAACCACA
ATAACGGCTCTCGAAGAAACAGGA -> TAACGGCTCTCGAAGAAACAGGAG
GTGATTGGTAGCGTAGAGTTTTTT -> TGATTGGTAGCGTAGAGTTTTTTT
TGTGCGGGTCATCGCACCATAGCA -> GTGCGGGTCATCGCACCATAGCAC
AGGTGTCGGCAGTCCTGGACGTCG -> GGTGTCGGCAGTCCTGGACGTCGG
GCCGCATTCACATAAGTCACGCGA -> CCGCATTCACATAAGTCACGCGAT
CAGAACTCGATTTCCATTCGAGAA -> AGAACTCGATTTCCATTCGAGAAC
GAACAACCCCATGAGAATCCGAAT -> AACAACCCCATGAGAATCCGAATT
ACTAAGTATCCGTGCTCGATCAAC -> CTAAGTATCCGTGCTCGATCAACG
ATTGCGTGTGACGTTTCCCACGGG -> TTGCGTGTGACGTTTCCCACGGGC
GAGTCTGAGAGACTGTGAAAATGA -> AGTCTGAGAGACTGTGAAAATGAC
AATCTGACGCTAGGTCCACACGTC -> ATCTGACGCTAGGTCCACACGTCG
CCCGCTACAGTCTCAAATCTGACG -> CCGCTACAGTCTCAAATCTGACGC
CACCTCAGTCGAGAACGTCCACTT -> ACCTCAGTCGAGAACGTCCACTTT
GCATGGGTGTGACGCTTCGCGCGA -> CATGGGTGTGACGCTTCGCGCGAC
AACATCGTGACCTGAGTGCTCGTT -> ACATCGTGACCTGAGTGCTCGTTA
ACCACAGGTCGGATTATGGTATAT -> CCACAGGTCGGATTATGGTATATG
CATACACGGGAAACGGGAAAGGGA -> ATACACGGGAAACGGGAAAGGGAC
AGACGCATCGAGACAAGCATGGAG -> GACGCATCGAGACAAGCATGGAGA
AAATTTATCGCCGCATTCACATAA -> AATTTATCGCCGCATTCACATAAG
AACAACCCCATGAGAATCCGAATT -> ACAACCCCATGAGAATCCGAATTG
ATCACACAACATCTCTTCTCTTCT -> TCACACAACATCTCTTCTCTTCTT
GCTCAGGATGTATGACCATACACG -> CTCAGGATGTATGACCATACACGG
AGCATGGAGACTCTTGGGTCCCCG -> GCATGGAGACTCTTGGGTCCCCGT
AGAATTGGATCAGAACAGCAGCGG -> GAATTGGATCAGAACAGCAGCGGA
AGAAGAGGTCCTGAAGGCTCGCAT -> GAAGAGGTCCTGAAGGCTCGCATT
GGTGTGACGCTTCGCGCGACTAGA -> GTGTGACGCTTCGCGCGACTAGAC
TGTGACGTTTCCCACGGGCTGAAT -> GTGACGTTTCCCACGGGCTGAATC
GACGCATCGAGACAAGCATGGAGA -> ACGCATCGAGACAAGCATGGAGAC
TGCCAATAGGCACTATACCTAGCC -> GCCAATAGGCACTATACCTAGCCC
ACCTCAGTCGAGAACGTCCACTTT -> CCTCAGTCGAGAACGTCCACTTTG
TAACCCGCAACACAGATACCAAGA -> AACCCGCAACACAGATACCAAGAA
TCTCCACCCATGACGATTGTAGAC -> CTCCACCCATGACGATTGTAGACG
CTACCCGCTAACCCGCAACACAGA -> TACCCGCTAACCCGCAACACAGAT
ACCAGCGATTGCGTGTGACGTTTC -> CCAGCGATTGCGTGTGACGTTTCC
TGGGCCGATACTGACCCCTGGACC -> GGGCCGATACTGACCCCTGGACCC
GGCGACGTCGTTTACGCCATAGCT -> GCGACGTCGTTTACGCCATAGCTG
ATGTGCTGCGCGCATATTGAGGTG -> TGTGCTGCGCGCATATTGAGGTGT
TGGTATATGTGCGGGTCATCGCAC -> GGTATATGTGCGGGTCATCGCACC
GAAAATGACACGTGTGCCCAATGG -> AAAATGACACGTGTGCCCAATGGG
TGGGTCGCCACGTTGAAGGAGGTC -> GGGTCGCCACGTTGAAGGAGGTCG
ACGAAGTTTCGAGGCGACGTCGTT -> CGAAGTTTCGAGGCGACGTCGTTT
TACACATTCCTATCTATTTCACGA -> ACACATTCCTATCTATTTCACGAG
TGGCTTGGCCAGTTGCATAGGAGG -> GGCTTGGCCAGTTGCATAGGAGGG
CACTAGCTCCTGCGAACCACAGGT -> ACTAGCTCCTGCGAACCACAGGTC
ACGCCGACTTTGAACATGTGAGTT -> CGCCGACTTTGAACATGTGAGTTC
GTCTCCCATTTACGTGTGTCCTTC -> TCTCCCATTTACGTGTGTCCTTCG
CGACTAGACGCCGGAGGCACGCTG -> GACTAGACGCCGGAGGCACGCTGG
CGAACGAGAGTTAGTCCCGATATG -> GAACGAGAGTTAGTCCCGATATGG
CTCATGATGAAATACCATATGTGC -> TCATGATGAAATACCATATGTGCT
GAGTCATTAGCTGGGAAGAAGAAG -> AGTCATTAGCTGGGAAGAAGAAGA
AGGGTATGAACCACGACCGCTTGG -> GGGTATGAACCACGACCGCTTGGA
TGACGCTAGGTCCACACGTCGAGA -> GACGCTAGGTCCACACGTCGAGAC
AAGCATGGAGACTCTTGGGTCCCC -> AGCATGGAGACTCTTGGGTCCCCG
ATCCCACCGACACACTCAGTGAGT -> TCCCACCGACACACTCAGTGAGTA
CGAACAACCCCATGAGAATCCGAA -> GAACAACCCCATGAGAATCCGAAT
CTAGCACCTCAGTCGAGAACGTCC -> TAGCACCTCAGTCGAGAACGTCCA
GCGGGTCATCGCACCATAGCACTA -> CGGGTCATCGCACCATAGCACTAC
GTGTGCCCAATGGGCGTTTCCATG -> TGTGCCCAATGGGCGTTTCCATGT
CGTATGGGCCGATACTGACCCCTG -> GTATGGGCCGATACTGACCCCTGG
AACAGCAGCGGACCGGCATGGGCG -> ACAGCAGCGGACCGGCATGGGCGA
GTCCACTTTGAAACATGCCAATAG -> TCCACTTTGAAACATGCCAATAGG
GTGGTTCGGGTGATTGGTAGCGTA -> TGGTTCGGGTGATTGGTAGCGTAG
CCGGCTTACGAAATTTATCGCCGC -> CGGCTTACGAAATTTATCGCCGCA
GAAATACCATATGTGCTGCGCGCA -> AAATACCATATGTGCTGCGCGCAT
GCTCTAGCACCTCAGTCGAGAACG -> CTCTAGCACCTCAGTCGAGAACGT
GTTTATTGAGTCATTAGCTGGGAA -> TTTATTGAGTCATTAGCTGGGAAG
GACCATACACGGGAAACGGGAAAG -> ACCATACACGGGAAACGGGAAAGG
CTATCTATTTCACGAGTACGTTAA -> TATCTATTTCACGAGTACGTTAAC
CGGGTACTTATGGATATGGACGAG -> GGGTACTTATGGATATGGACGAGA
CACTATACCTAGCCCTCTATCGGG -> ACTATACCTAGCCCTCTATCGGGG
GAAAGGGACTTACAATAGTCTCCC -> AAAGGGACTTACAATAGTCTCCCA
AGCGGACCGGCATGGGCGATACAG -> GCGGACCGGCATGGGCGATACAGC
CTCTGTTCTCCAGAAGATCTCGTG -> TCTGTTCTCCAGAAGATCTCGTGG
TTCTCCAGAAGATCTCGTGGTTCG -> TCTCCAGAAGATCTCGTGGTTCGG
GATACGTCGGGCGGGAAATCCGTC -> ATACGTCGGGCGGGAAATCCGTCT
TACTAGATAGGGGGCTCCTCCACC -> ACTAGATAGGGGGCTCCTCCACCA
GTCGGACTTTTATTGCGGCGGTCG -> TCGGACTTTTATTGCGGCGGTCGA
ATGACCATACACGGGAAACGGGAA -> TGACCATACACGGGAAACGGGAAA
GTCAAAGGTTATTACATAAAACGA -> TCAAAGGTTATTACATAAAACGAT
CTGCGAACCACAGGTCGGATTATG -> TGCGAACCACAGGTCGGATTATGG
TATTGTATTCAGTTGTCGGCCTGC -> ATTGTATTCAGTTGTCGGCCTGCA
ATACAGCCCGACATTTGGCTTGGC -> TACAGCCCGACATTTGGCTTGGCC
AACGGTGTGGCGAACGTCAAAATA -> ACGGTGTGGCGAACGTCAAAATAC
GAAGCTTGAGACGAGTCTGAGAGA -> AAGCTTGAGACGAGTCTGAGAGAC
ACGCGATAGCGGCTGCTTCCATAG -> CGCGATAGCGGCTGCTTCCATAGG
GAAGAGGTCCTGAAGGCTCGCATT -> AAGAGGTCCTGAAGGCTCGCATTT
ACGTCGAGACGAATTACTAGATAG -> CGTCGAGACGAATTACTAGATAGG
TGTATGACCATACACGGGAAACGG -> GTATGACCATACACGGGAAACGGG
GGGTGTGACGCTTCGCGCGACTAG -> GGTGTGACGCTTCGCGCGACTAGA
CGGCGTGTTGGCGGGACAATGTTG -> GGCGTGTTGGCGGGACAATGTTGA
TTCCATAGGCTAAGACGCCGACTT -> TCCATAGGCTAAGACGCCGACTTT
ACTCCGGTTTGTGAAATACAATTA -> CTCCGGTTTGTGAAATACAATTAT
CTATATTTAAATCGCCAGAACTCG -> TATATTTAAATCGCCAGAACTCGA
AACCCGCAACACAGATACCAAGAA -> ACCCGCAACACAGATACCAAGAAT
CGGCTCTCGAAGAAACAGGAGGAC -> GGCTCTCGAAGAAACAGGAGGACG
ACGCTAGGTCCACACGTCGAGACG -> CGCTAGGTCCACACGTCGAGACGA
GCACGCTGGACCCCATCTCCACCC -> CACGCTGGACCCCATCTCCACCCA
CCCTGGACCCGCTACAGTCTCAAA -> CCTGGACCCGCTACAGTCTCAAAT
GACACGTGTGCCCAATGGGCGTTT -> ACACGTGTGCCCAATGGGCGTTTC
CCATGAGAATCCGAATTGCAACAT -> CATGAGAATCCGAATTGCAACATC
GTCTGTACTCTTGTCGGGTACTTA -> TCTGTACTCTTGTCGGGTACTTAT
GAGTACGTTAACGCTGTAAAATTC -> AGTACGTTAACGCTGTAAAATTCC
ACCTAGCCCTCTATCGGGGATGAC -> CCTAGCCCTCTATCGGGGATGACT
GCGATTGCGTGTGACGTTTCCCAC -> CGATTGCGTGTGACGTTTCCCACG
TCTCGAAGAAACAGGAGGACGGTT -> CTCGAAGAAACAGGAGGACGGTTA
ACTTTAGACAAGAAAAATGCTTCG -> CTTTAGACAAGAAAAATGCTTCGC
AGTCATTAGCTGGGAAGAAGAAGA -> GTCATTAGCTGGGAAGAAGAAGAG
CAGGATGTATGACCATACACGGGA -> AGGATGTATGACCATACACGGGAA
GGCGTTTCCATGTCTCTCTATATT -> GCGTTTCCATGTCTCTCTATATTT
TATGGGCCGATACTGACCCCTGGA -> ATGGGCCGATACTGACCCCTGGAC
CTGTGCCTGACAACTGACTTTAAG -> TGTGCCTGACAACTGACTTTAAGC
CCCATCTCCACCCATGACGATTGT -> CCATCTCCACCCATGACGATTGTA
TGGCTGTGGGCGGCTGCATAGCAG -> GGCTGTGGGCGGCTGCATAGCAGA
CCGGCATGGGCGATACAGCCCGAC -> CGGCATGGGCGATACAGCCCGACA
GAAGGAGGTCGCAGCACTAGCTCC -> AAGGAGGTCGCAGCACTAGCTCCT
CCGCAACGCTCACCCTTAGATCAA -> CGCAACGCTCACCCTTAGATCAAT
GTATCCGTGCTCGATCAACGTTTA -> TATCCGTGCTCGATCAACGTTTAT
GAGAACTAACGGTGTGGCGAACGT -> AGAACTAACGGTGTGGCGAACGTC
CTGTAAAATTCCGTATGGGCCGAT -> TGTAAAATTCCGTATGGGCCGATA
ACCCACTGTGGCTCTAGCACCTCA -> CCCACTGTGGCTCTAGCACCTCAG
TCATTAATAAGAATGTAGTTATAT -> CATTAATAAGAATGTAGTTATATG
GCCTCCGGCTTGGCGAAAAGCTAA -> CCTCCGGCTTGGCGAAAAGCTAAG
GACGCCGGAGGCACGCTGGACCCC -> ACGCCGGAGGCACGCTGGACCCCA
AGACGAGTCTGAGAGACTGTGAAA -> GACGAGTCTGAGAGACTGTGAAAA
AAATCCGTCTCTGTTCTCCAGAAG -> AATCCGTCTCTGTTCTCCAGAAGA
CCTGCATGGGTGTGACGCTTCGCG -> CTGCATGGGTGTGACGCTTCGCGC
ACTCAGTGAGTATTACGCGTTAAG -> CTCAGTGAGTATTACGCGTTAAGT
TACCTAGCCCTCTATCGGGGATGA -> ACCTAGCCCTCTATCGGGGATGAC
GTGCGATGGGGCTTTAGTTCAAGT -> TGCGATGGGGCTTTAGTTCAAGTA
CCTTTGGTAAATCAATCCACGATA -> CTTTGGTAAATCAATCCACGATAA
ACGCATCGAGACAAGCATGGAGAC -> CGCATCGAGACAAGCATGGAGACT
TGAAATACCATATGTGCTGCGCGC -> GAAATACCATATGTGCTGCGCGCA
TTAGACAAGAAAAATGCTTCGCCT -> TAGACAAGAAAAATGCTTCGCCTC
GCGGTCGAACGAGAGTTAGTCCCG -> CGGTCGAACGAGAGTTAGTCCCGA
ACACTCAGTGAGTATTACGCGTTA -> CACTCAGTGAGTATTACGCGTTAA
TTTGGCTTGGCCAGTTGCATAGGA -> TTGGCTTGGCCAGTTGCATAGGAG
ATAAGGTGCATTGAGATCACACAA -> TAAGGTGCATTGAGATCACACAAC
TCGGGTACTTATGGATATGGACGA -> CGGGTACTTATGGATATGGACGAG
TAGTCCCCTTTGGTAAATCAATCC -> AGTCCCCTTTGGTAAATCAATCCA
TGACGTTTCCCACGGGCTGAATCT -> GACGTTTCCCACGGGCTGAATCTC
CTCACCCTTAGATCAATTCCCGCT -> TCACCCTTAGATCAATTCCCGCTC
TCTAATACGGTCCACAAATCGGTT -> CTAATACGGTCCACAAATCGGTTG
AAAATGCACAATCGACCCACTGTG -> AAATGCACAATCGACCCACTGTGG
AAGTTTCGAGGCGACGTCGTTTAC -> AGTTTCGAGGCGACGTCGTTTACG
AGCATCCCACCGACACACTCAGTG -> GCATCCCACCGACACACTCAGTGA
AATTCCCGCTCTTAAACCGCAGTT -> ATTCCCGCTCTTAAACCGCAGTTT
CACAGATACCAAGAATTGGATCAG -> ACAGATACCAAGAATTGGATCAGA
AGAAGATCTCGTGGTTCGGGTGAT -> GAAGATCTCGTGGTTCGGGTGATT
GCAGCGGACCGGCATGGGCGATAC -> CAGCGGACCGGCATGGGCGATACA
GCTTCGCGCGACTAGACGCCGGAG -> CTTCGCGCGACTAGACGCCGGAGG
TAGAGTTTTTTTTCCCGCGAAGCT -> AGAGTTTTTTTTCCCGCGAAGCTC
CGAATTTCCCAGTTTGGTGTTTTG -> GAATTTCCCAGTTTGGTGTTTTGC
TAAATTCGCCCGCCTGTCTAGCAT -> AAATTCGCCCGCCTGTCTAGCATG
ATTTCACGAGTACGTTAACGCTGT -> TTTCACGAGTACGTTAACGCTGTA
CCATTCGAGAACTAACGGTGTGGC -> CATTCGAGAACTAACGGTGTGGCG
TCAGGATGTATGACCATACACGGG -> CAGGATGTATGACCATACACGGGA
CTAAGGCTTTTCGATACGTCGGGC -> TAAGGCTTTTCGATACGTCGGGCG
ACAGCAGCGGACCGGCATGGGCGA -> CAGCAGCGGACCGGCATGGGCGAT
ACATTTGGCTTGGCCAGTTGCATA -> CATTTGGCTTGGCCAGTTGCATAG
CCACAGGTCGGATTATGGTATATG -> CACAGGTCGGATTATGGTATATGT
TCGACCCACTGTGGCTCTAGCACC -> CGACCCACTGTGGCTCTAGCACCT
AGAATCCGAATTGCAACATCGTGA -> GAATCCGAATTGCAACATCGTGAC
GGTCATCGCACCATAGCACTACCC -> GTCATCGCACCATAGCACTACCCG
AAGCTAAGGCTTTTCGATACGTCG -> AGCTAAGGCTTTTCGATACGTCGG
GCCAGGTTCACTCATTAATAAGAA -> CCAGGTTCACTCATTAATAAGAAT
AAGAAAAATGCTTCGCCTCCGGCT -> AGAAAAATGCTTCGCCTCCGGCTT
CGTAGAGTTTTTTTTCCCGCGAAG -> GTAGAGTTTTTTTTCCCGCGAAGC
TTGAGATCACACAACATCTCTTCT -> TGAGATCACACAACATCTCTTCTC
CTGCATAGCAGAAGGTCCTCGGAA -> TGCATAGCAGAAGGTCCTCGGAAC
TGTCCTTCGGCGTGTTGGCGGGAC -> GTCCTTCGGCGTGTTGGCGGGACA
ACACACTCAGTGAGTATTACGCGT -> CACACTCAGTGAGTATTACGCGTT
CACGGGAAACGGGAAAGGGACTTA -> ACGGGAAACGGGAAAGGGACTTAC
ACAGATACCAAGAATTGGATCAGA -> CAGATACCAAGAATTGGATCAGAA
TAGACGCCGGAGGCACGCTGGACC -> AGACGCCGGAGGCACGCTGGACCC
GGAAAGGGACTTACAATAGTCTCC -> GAAAGGGACTTACAATAGTCTCCC
AAGGTTATTACATAAAACGATCTC -> AGGTTATTACATAAAACGATCTCC
CACGCGATAGCGGCTGCTTCCATA -> ACGCGATAGCGGCTGCTTCCATAG
ATCTAAATTCGCCCGCCTGTCTAG -> TCTAAATTCGCCCGCCTGTCTAGC
ATAGCGGCTGCTTCCATAGGCTAA -> TAGCGGCTGCTTCCATAGGCTAAG
CTCCTGCGAACCACAGGTCGGATT -> TCCTGCGAACCACAGGTCGGATTA
TCTGAGAGACTGTGAAAATGACAC -> CTGAGAGACTGTGAAAATGACACG
TAGGCACTATACCTAGCCCTCTAT -> AGGCACTATACCTAGCCCTCTATC
GCATATTGAGGTGTCGGCAGTCCT -> CATATTGAGGTGTCGGCAGTCCTG
CCGCATTCACATAAGTCACGCGAT -> CGCATTCACATAAGTCACGCGATA
CCATAGCTGTGCCTGACAACTGAC -> CATAGCTGTGCCTGACAACTGACT
GCCAATAGGCACTATACCTAGCCC -> CCAATAGGCACTATACCTAGCCCT
CTGTCGCCAGGTTCACTCATTAAT -> TGTCGCCAGGTTCACTCATTAATA
ACGATAATCACATACACGAAGTTT -> CGATAATCACATACACGAAGTTTC
TCACTTAGCGAACAACCCCATGAG -> CACTTAGCGAACAACCCCATGAGA
AGAGAAGAATGTGTCTGTACTCTT -> GAGAAGAATGTGTCTGTACTCTTG
TCCATTCGAGAACTAACGGTGTGG -> CCATTCGAGAACTAACGGTGTGGC
CCGACATTTGGCTTGGCCAGTTGC -> CGACATTTGGCTTGGCCAGTTGCA
TAGATCAATTCCCGCTCTTAAACC -> AGATCAATTCCCGCTCTTAAACCG
TATTACATAAAACGATCTCCGTTG -> ATTACATAAAACGATCTCCGTTGT
AAATGACACGTGTGCCCAATGGGC -> AATGACACGTGTGCCCAATGGGCG
ACTCTTGGGTCCCCGTGCGATGGG -> CTCTTGGGTCCCCGTGCGATGGGG
CAACGTTTATTGAGTCATTAGCTG -> AACGTTTATTGAGTCATTAGCTGG
AAATTCCGTATGGGCCGATACTGA -> AATTCCGTATGGGCCGATACTGAC
GCTAACCCGCAACACAGATACCAA -> CTAACCCGCAACACAGATACCAAG
TTACGCCATAGCTGTGCCTGACAA -> TACGCCATAGCTGTGCCTGACAAC
ACTTTGAAACATGCCAATAGGCAC -> CTTTGAAACATGCCAATAGGCACT
GGTCGCAGCACTAGCTCCTGCGAA -> GTCGCAGCACTAGCTCCTGCGAAC
CCAGCGATTGCGTGTGACGTTTCC -> CAGCGATTGCGTGTGACGTTTCCC
AAGCTCGAATTTCCCAGTTTGGTG -> AGCTCGAATTTCCCAGTTTGGTGT
AGAACTAACGGTGTGGCGAACGTC -> GAACTAACGGTGTGGCGAACGTCA
TATGACCATACACGGGAAACGGGA -> ATGACCATACACGGGAAACGGGAA
AGACATGGTACTTCCGGTATTTTT -> GACATGGTACTTCCGGTATTTTTC
CAAATCGGTTGCTGGTTGCTCACT -> AAATCGGTTGCTGGTTGCTCACTT
CGCATCGAGACAAGCATGGAGACT -> GCATCGAGACAAGCATGGAGACTC
CGGTTATAAGGTGCATTGAGATCA -> GGTTATAAGGTGCATTGAGATCAC
GCTGAATCTCACTTAGCGAACAAC -> CTGAATCTCACTTAGCGAACAACC
CTCTCTATATTTAAATCGCCAGAA -> TCTCTATATTTAAATCGCCAGAAC
GGTCCTCGGAACTTTAGACAAGAA -> GTCCTCGGAACTTTAGACAAGAAA
TAGCAGAAGGTCCTCGGAACTTTA -> AGCAGAAGGTCCTCGGAACTTTAG
GGGCCGATACTGACCCCTGGACCC -> GGCCGATACTGACCCCTGGACCCG
ACTCATTAATAAGAATGTAGTTAT -> CTCATTAATAAGAATGTAGTTATA
CGGGACAATGTTGATCCGCAACGC -> GGGACAATGTTGATCCGCAACGCT
CAACCAAGACATGGTACTTCCGGT -> AACCAAGACATGGTACTTCCGGTA
TCGAGAACGTCCACTTTGAAACAT -> CGAGAACGTCCACTTTGAAACATG
CAATAGGCACTATACCTAGCCCTC -> AATAGGCACTATACCTAGCCCTCT
ACCCTTATAACGGCTCTCGAAGAA -> CCCTTATAACGGCTCTCGAAGAAA
AAGGCTTTTCGATACGTCGGGCGG -> AGGCTTTTCGATACGTCGGGCGGG
TCGTTATCTAAATTCGCCCGCCTG -> CGTTATCTAAATTCGCCCGCCTGT
CTTTAAGCATCCCACCGACACACT -> TTTAAGCATCCCACCGACACACTC
GAAAAAATGCACAATCGACCCACT -> AAAAAATGCACAATCGACCCACTG
GCTTGGACTGAACCCTTATAACGG -> CTTGGACTGAACCCTTATAACGGC
TTTTTTTTCCCGCGAAGCTCGAAT -> TTTTTTTCCCGCGAAGCTCGAATT
ACAAATCGGTTGCTGGTTGCTCAC -> CAAATCGGTTGCTGGTTGCTCACT
AGATCACACAACATCTCTTCTCTT -> GATCACACAACATCTCTTCTCTTC
GCCTTTAGCTCAGGATGTATGACC -> CCTTTAGCTCAGGATGTATGACCA
ACACAACATCTCTTCTCTTCTTGG -> CACAACATCTCTTCTCTTCTTGGG
TGCCTTTAGCTCAGGATGTATGAC -> GCCTTTAGCTCAGGATGTATGACC
GGACTTTTATTGCGGCGGTCGAAC -> GACTTTTATTGCGGCGGTCGAACG
ACAGCCCGACATTTGGCTTGGCCA -> CAGCCCGACATTTGGCTTGGCCAG
CAGTGAGTATTACGCGTTAAGTAT -> AGTGAGTATTACGCGTTAAGTATC
CATGAGAATCCGAATTGCAACATC -> ATGAGAATCCGAATTGCAACATCG
ATACCAAGAATTGGATCAGAACAG -> TACCAAGAATTGGATCAGAACAGC
ATAATCACATACACGAAGTTTCGA -> TAATCACATACACGAAGTTTCGAG
AACTGACTTTAAGCATCCCACCGA -> ACTGACTTTAAGCATCCCACCGAC
TTAGATCAATTCCCGCTCTTAAAC -> TAGATCAATTCCCGCTCTTAAACC
CTCAGTCGAGAACGTCCACTTTGA -> TCAGTCGAGAACGTCCACTTTGAA
CCTGTCGCCAGGTTCACTCATTAA -> CTGTCGCCAGGTTCACTCATTAAT
CGTGGTTCGGGTGATTGGTAGCGT -> GTGGTTCGGGTGATTGGTAGCGTA
ACCGACACACTCAGTGAGTATTAC -> CCGACACACTCAGTGAGTATTACG
CGATACGTCGGGCGGGAAATCCGT -> GATACGTCGGGCGGGAAATCCGTC
CGAAGAAACAGGAGGACGGTTATA -> GAAGAAACAGGAGGACGGTTATAA
AAAAAATGCACAATCGACCCACTG -> AAAAATGCACAATCGACCCACTGT
AATAGTCTCCCATTTACGTGTGTC -> ATAGTCTCCCATTTACGTGTGTCC
GACGTCGTTTACGCCATAGCTGTG -> ACGTCGTTTACGCCATAGCTGTGC
ACGCTGGACCCCATCTCCACCCAT -> CGCTGGACCCCATCTCCACCCATG
CGATCAACGTTTATTGAGTCATTA -> GATCAACGTTTATTGAGTCATTAG
CTTCCGGTATTTTTCGAGAGAAGA -> TTCCGGTATTTTTCGAGAGAAGAA
TCGATACGTCGGGCGGGAAATCCG -> CGATACGTCGGGCGGGAAATCCGT
CGGGTGATTGGTAGCGTAGAGTTT -> GGGTGATTGGTAGCGTAGAGTTTT
GGTGATTGGTAGCGTAGAGTTTTT -> GTGATTGGTAGCGTAGAGTTTTTT
TTTGCCTTTAGCTCAGGATGTATG -> TTGCCTTTAGCTCAGGATGTATGA
CCGTGCGATGGGGCTTTAGTTCAA -> CGTGCGATGGGGCTTTAGTTCAAG
CCACGATAATCACATACACGAAGT -> CACGATAATCACATACACGAAGTT
GCACTAGCTCCTGCGAACCACAGG -> CACTAGCTCCTGCGAACCACAGGT
CGATAATCACATACACGAAGTTTC -> GATAATCACATACACGAAGTTTCG
CAGTCGAGAACGTCCACTTTGAAA -> AGTCGAGAACGTCCACTTTGAAAC
TGTCGCCAGGTTCACTCATTAATA -> GTCGCCAGGTTCACTCATTAATAA
TTCCCAGTTTGGTGTTTTGCCTTT -> TCCCAGTTTGGTGTTTTGCCTTTA
TGGAAAAAATGCACAATCGACCCA -> GGAAAAAATGCACAATCGACCCAC
GAGGTCGCAGCACTAGCTCCTGCG -> AGGTCGCAGCACTAGCTCCTGCGA
ACTTGACATGGACTAAGTATCCGT -> CTTGACATGGACTAAGTATCCGTG
AAACATGCCAATAGGCACTATACC -> AACATGCCAATAGGCACTATACCT
GCTTGAGACGAGTCTGAGAGACTG -> CTTGAGACGAGTCTGAGAGACTGT
GGCTAAGACGCCGACTTTGAACAT -> GCTAAGACGCCGACTTTGAACATG
ACTGCTCATGATGAAATACCATAT -> CTGCTCATGATGAAATACCATATG
TCCCATTTACGTGTGTCCTTCGGC -> CCCATTTACGTGTGTCCTTCGGCG
GGAGACTCTTGGGTCCCCGTGCGA -> GAGACTCTTGGGTCCCCGTGCGAT
GGCCAGTTGCATAGGAGGGTATGA -> GCCAGTTGCATAGGAGGGTATGAA
AGGTCCTCGGAACTTTAGACAAGA -> GGTCCTCGGAACTTTAGACAAGAA
TTCGCGCGACTAGACGCCGGAGGC -> TCGCGCGACTAGACGCCGGAGGCA
GACATGGACTAAGTATCCGTGCTC -> ACATGGACTAAGTATCCGTGCTCG
TCCTATCTATTTCACGAGTACGTT -> CCTATCTATTTCACGAGTACGTTA
GAACCACGACCGCTTGGACTGAAC -> AACCACGACCGCTTGGACTGAACC
AGAGTTTTTTTTCCCGCGAAGCTC -> GAGTTTTTTTTCCCGCGAAGCTCG
GCACTACCCGCTAACCCGCAACAC -> CACTACCCGCTAACCCGCAACACA
CGAGAGAAGAATGTGTCTGTACTC -> GAGAGAAGAATGTGTCTGTACTCT
GGTACTTATGGATATGGACGAGAT -> GTACTTATGGATATGGACGAGATT
GTTCACTCATTAATAAGAATGTAG -> TTCACTCATTAATAAGAATGTAGT
AGGCTCGCATTTCGTCCGGCTTAC -> GGCTCGCATTTCGTCCGGCTTACG
GGTTGCTGGTTGCTCACTTGACAT -> GTTGCTGGTTGCTCACTTGACATG
ATAGTCTCCCATTTACGTGTGTCC -> TAGTCTCCCATTTACGTGTGTCCT
TATCTATTTCACGAGTACGTTAAC -> ATCTATTTCACGAGTACGTTAACG
GACGTTTCCCACGGGCTGAATCTC -> ACGTTTCCCACGGGCTGAATCTCA
TCGAGAACTAACGGTGTGGCGAAC -> CGAGAACTAACGGTGTGGCGAACG
GTTTGGTGTTTTGCCTTTAGCTCA -> TTTGGTGTTTTGCCTTTAGCTCAG
AGGCGACGTCGTTTACGCCATAGC -> GGCGACGTCGTTTACGCCATAGCT
AATACAATTATTAGTCCCCTTTGG -> ATACAATTATTAGTCCCCTTTGGT
TATACCTAGCCCTCTATCGGGGAT -> ATACCTAGCCCTCTATCGGGGATG
CAGTCTCAAATCTGACGCTAGGTC -> AGTCTCAAATCTGACGCTAGGTCC
ACTTATGGATATGGACGAGATTGA -> CTTATGGATATGGACGAGATTGAC
CGAAATTTATCGCCGCATTCACAT -> GAAATTTATCGCCGCATTCACATA
GGGAAGAAGAAGAGGTCCTGAAGG -> GGAAGAAGAAGAGGTCCTGAAGGC
CGGCATGGGCGATACAGCCCGACA -> GGCATGGGCGATACAGCCCGACAT
AGTCACGCGATAGCGGCTGCTTCC -> GTCACGCGATAGCGGCTGCTTCCA
CACCGACACACTCAGTGAGTATTA -> ACCGACACACTCAGTGAGTATTAC
ACCAAGAATTGGATCAGAACAGCA -> CCAAGAATTGGATCAGAACAGCAG
TGTGAAAATGACACGTGTGCCCAA -> GTGAAAATGACACGTGTGCCCAAT
TTCGAGGCGACGTCGTTTACGCCA -> TCGAGGCGACGTCGTTTACGCCAT
CATGCCAATAGGCACTATACCTAG -> ATGCCAATAGGCACTATACCTAGC
AGACGAATTACTAGATAGGGGGCT -> GACGAATTACTAGATAGGGGGCTC
TAAGTCACGCGATAGCGGCTGCTT -> AAGTCACGCGATAGCGGCTGCTTC
TATCCGTGCTCGATCAACGTTTAT -> ATCCGTGCTCGATCAACGTTTATT
GACGATTGTAGACGCATCGAGACA -> ACGATTGTAGACGCATCGAGACAA
TCAGTTGTCGGCCTGCATGGGTGT -> CAGTTGTCGGCCTGCATGGGTGTG
ACGTCGGGCGGGAAATCCGTCTCT -> CGTCGGGCGGGAAATCCGTCTCTG
GGGAAATCCGTCTCTGTTCTCCAG -> GGAAATCCGTCTCTGTTCTCCAGA
GGGATGACTCCGGTTTGTGAAATA -> GGATGACTCCGGTTTGTGAAATAC
CATTCGAGAACTAACGGTGTGGCG -> ATTCGAGAACTAACGGTGTGGCGA
CCTCAGTCGAGAACGTCCACTTTG -> CTCAGTCGAGAACGTCCACTTTGA
TTCAACCAAGACATGGTACTTCCG -> TCAACCAAGACATGGTACTTCCGG
AGGTCGCAGCACTAGCTCCTGCGA -> GGTCGCAGCACTAGCTCCTGCGAA
AAGTATCCACCGTGTCAAAGGTTA -> AGTATCCACCGTGTCAAAGGTTAT
CTCATTAATAAGAATGTAGTTATA -> TCATTAATAAGAATGTAGTTATAT
CGGGGATGACTCCGGTTTGTGAAA -> GGGGATGACTCCGGTTTGTGAAAT
TTTCCATTCGAGAACTAACGGTGT -> TTCCATTCGAGAACTAACGGTGTG
GTCAAAATACACATTCCTATCTAT -> TCAAAATACACATTCCTATCTATT
CACGTTGAAGGAGGTCGCAGCACT -> ACGTTGAAGGAGGTCGCAGCACTA
GACGATCTTGGAAAAAATGCACAA -> ACGATCTTGGAAAAAATGCACAAT
AGCTCAGGATGTATGACCATACAC -> GCTCAGGATGTATGACCATACACG
ACAGTCTCAAATCTGACGCTAGGT -> CAGTCTCAAATCTGACGCTAGGTC
CTTTGGTAAATCAATCCACGATAA -> TTTGGTAAATCAATCCACGATAAT
TTGACATGGACTAAGTATCCGTGC -> TGACATGGACTAAGTATCCGTGCT
TATCGGGGATGACTCCGGTTTGTG -> ATCGGGGATGACTCCGGTTTGTGA
TTATTGAGTCATTAGCTGGGAAGA -> TATTGAGTCATTAGCTGGGAAGAA
GTACGTTAACGCTGTAAAATTCCG -> TACGTTAACGCTGTAAAATTCCGT
CGCTTCGCGCGACTAGACGCCGGA -> GCTTCGCGCGACTAGACGCCGGAG
GCCTGACAACTGACTTTAAGCATC -> CCTGACAACTGACTTTAAGCATCC
TTCCATGTCTCTCTATATTTAAAT -> TCCATGTCTCTCTATATTTAAATC
GGATATGGACGAGATTGACGTGGC -> GATATGGACGAGATTGACGTGGCT
AGCACTACCCGCTAACCCGCAACA -> GCACTACCCGCTAACCCGCAACAC
ACCACGACCGCTTGGACTGAACCC -> CCACGACCGCTTGGACTGAACCCT
GAACGTCCACTTTGAAACATGCCA -> AACGTCCACTTTGAAACATGCCAA
AGCACCTCAGTCGAGAACGTCCAC -> GCACCTCAGTCGAGAACGTCCACT
GACTGTGAAAATGACACGTGTGCC -> ACTGTGAAAATGACACGTGTGCCC
GTGACGTTTCCCACGGGCTGAATC -> TGACGTTTCCCACGGGCTGAATCT
TGTAAAATTCCGTATGGGCCGATA -> GTAAAATTCCGTATGGGCCGATAC
CCGTTGTTCTCGTCGAAGCTTGAG -> CGTTGTTCTCGTCGAAGCTTGAGA
GATCAATTCCCGCTCTTAAACCGC -> ATCAATTCCCGCTCTTAAACCGCA
TGAAAATGACACGTGTGCCCAATG -> GAAAATGACACGTGTGCCCAATGG
GCCAGTTGCATAGGAGGGTATGAA -> CCAGTTGCATAGGAGGGTATGAAC
TTTTTCGAGAGAAGAATGTGTCTG -> TTTTCGAGAGAAGAATGTGTCTGT
CTTTTCGATACGTCGGGCGGGAAA -> TTTTCGATACGTCGGGCGGGAAAT
TACAGCCCGACATTTGGCTTGGCC -> ACAGCCCGACATTTGGCTTGGCCA
